id,banco,fecha_operacion,descripcion,referencia,monto,saldo_operacion,etiqueta,
1,BBVA,01/12/2024,T20 SPEI RECIBIDOBANORTE,,4060,,Deposito,X
2,BBVA,02/12/2024,Z3 CARGO COBRANZA FACILEASIN,,12079.2,,Retiro,
3,BBVA,02/12/2024,T20 SPEI RECIBIDOSCOTIABANK,,3250,,Deposito,
4,BBVA,02/12/2024,W02 DEPOSITO DE TERCERO,,19720,,Deposito,
5,BBVA,02/12/2024,W02 DEPOSITO DE TERCERO,,19256,,Deposito,
6,BBVA,02/12/2024,P14 TELCEL,,449,,Retiro,
7,BBVA,03/12/2024,N03 TRASPASO CUENTAS PROPIAS,,77821.6,,Retiro,
8,BBVA,03/12/2024,T20 SPEI RECIBIDOSANTANDER,,5800,,Deposito,
9,BBVA,03/12/2024,W02 DEPOSITO DE TERCERO,,71050,,Deposito,
10,BBVA,03/12/2024,N06 PAGO CUENTA DE TERCERO,,7960,,Deposito,
11,BBVA,04/12/2024,T09 TEF RECIBIDO BANORTE,,12180,,Deposito,
12,BBVA,04/12/2024,N06 PAGO CUENTA DE TERCERO,,27550,,Deposito,
13,BBVA,04/12/2024,N06 PAGO CUENTA DE TERCERO,,13920,,Deposito,
14,BBVA,04/12/2024,T20 SPEI RECIBIDOSANTANDER,,81200,,Deposito,
15,BBVA,05/12/2024,W02 DEPOSITO DE TERCERO,,10440,,Deposito,
16,BBVA,05/12/2024,T20 SPEI RECIBIDOSANTANDER,,40000,,Deposito,
17,BBVA,05/12/2024,P14 AMERICAN EXPRESS,,31057.4,,Retiro,
18,BBVA,05/12/2024,N03 TRASPASO CUENTAS PROPIAS,,10292.2,,Retiro,
19,BBVA,05/12/2024,BT2 TRANSFER BBVA 01028855 L,,35650.8,,Deposito,
20,BBVA,06/12/2024,N03 TRASPASO CUENTAS PROPIAS,,12852.8,,Retiro,
21,BBVA,06/12/2024,T17 SPEI ENVIADO BANORTE,,18096,,Retiro,
22,BBVA,06/12/2024,T17 SPEI ENVIADO BANORTE,,38604.8,,Retiro,
23,BBVA,06/12/2024,N03 TRASPASO CUENTAS PROPIAS,,11000,,Retiro,
24,BBVA,06/12/2024,W02 DEPOSITO DE TERCERO,,27376,,Deposito,
25,BBVA,06/12/2024,W02 DEPOSITO DE TERCERO,,27840,,Deposito,
26,BBVA,08/12/2024,W02 DEPOSITO DE TERCERO,,5104,,Deposito,
27,BBVA,09/12/2024,W02 DEPOSITO DE TERCERO,,11600,,Deposito,
28,BBVA,09/12/2024,N06 PAGO CUENTA DE TERCERO,,15000,,Retiro,
29,BBVA,10/12/2024,N03 TRASPASO CUENTAS PROPIAS,,83520,,Deposito,
30,BBVA,10/12/2024,W02 DEPOSITO DE TERCERO,,22116.6,,Deposito,
31,BBVA,10/12/2024,N03 TRASPASO CUENTAS PROPIAS,,16167,,Retiro,
32,BBVA,10/12/2024,N06 PAGO CUENTA DE TERCERO,,800,,Retiro,
33,BBVA,11/12/2024,BT2 TRANSFER BBVA 00797189 L,,13572,,Deposito,
34,BBVA,11/12/2024,U05 DEPOSITO DE FIDUCIARIO,,24128,,Deposito,
35,BBVA,11/12/2024,N06 PAGO CUENTA DE TERCERO,,6960,,Deposito,
36,BBVA,11/12/2024,T20 SPEI RECIBIDOBANORTE,,24128,,Deposito,
37,BBVA,12/12/2024,T20 SPEI RECIBIDOBANORTE,,27966.3,,Deposito,
38,BBVA,12/12/2024,N02 PAGO TARJETA DE CREDITO,,35658.8,,Retiro,
39,BBVA,12/12/2024,W02 DEPOSITO DE TERCERO,,30160,,Deposito,
40,BBVA,13/12/2024,T20 SPEI RECIBIDOAFIRME,,26100,,Deposito,
41,BBVA,13/12/2024,N03 TRASPASO CUENTAS PROPIAS,,89655.8,,Retiro,
42,BBVA,13/12/2024,N03 TRASPASO CUENTAS PROPIAS,,61869.6,,Retiro,
43,BBVA,13/12/2024,N03 TRASPASO CUENTAS PROPIAS,,82388.4,,Retiro,
44,BBVA,13/12/2024,N03 TRASPASO CUENTAS PROPIAS,,76391.5,,Retiro,
45,BBVA,13/12/2024,N03 TRASPASO CUENTAS PROPIAS,,28874.9,,Retiro,
46,BBVA,13/12/2024,N06 PAGO CUENTA DE TERCERO,,9817.05,,Retiro,
47,BBVA,13/12/2024,W02 DEPOSITO DE TERCERO,,22011,,Deposito,
48,BBVA,13/12/2024,W02 DEPOSITO DE TERCERO,,32282.8,,Deposito,
49,BBVA,13/12/2024,W02 DEPOSITO DE TERCERO,,43326,,Deposito,
50,BBVA,13/12/2024,W02 DEPOSITO DE TERCERO,,5359.2,,Deposito,
51,BBVA,13/12/2024,W02 DEPOSITO DE TERCERO,,5359.2,,Deposito,
52,BBVA,13/12/2024,W02 DEPOSITO DE TERCERO,,2679.6,,Deposito,
53,BBVA,13/12/2024,W02 DEPOSITO DE TERCERO,,13015.2,,Deposito,
54,BBVA,13/12/2024,W02 DEPOSITO DE TERCERO,,13340,,Deposito,
55,BBVA,13/12/2024,N06 PAGO CUENTA DE TERCERO,,6090,,Deposito,
56,BBVA,13/12/2024,N03 TRASPASO CUENTAS PROPIAS,,16848.4,,Deposito,
57,BBVA,13/12/2024,N03 TRASPASO CUENTAS PROPIAS,,2800.03,,Retiro,
58,BBVA,13/12/2024,T20 SPEI RECIBIDOBANAMEX,,26100,,Deposito,
59,BBVA,13/12/2024,W02 DEPOSITO DE TERCERO,,23200,,Deposito,
60,BBVA,13/12/2024,T20 SPEI RECIBIDOSANTANDER,,9280,,Deposito,
61,BBVA,13/12/2024,W02 DEPOSITO DE TERCERO,,25520,,Deposito,
62,BBVA,13/12/2024,N06 PAGO CUENTA DE TERCERO,,3828,,Deposito,
63,BBVA,15/12/2024,N06 PAGO CUENTA DE TERCERO,,6380,,Deposito,
64,BBVA,16/12/2024,T20 SPEI RECIBIDOSCOTIABANK,,4344.44,,Deposito,
65,BBVA,16/12/2024,T20 SPEI RECIBIDOSCOTIABANK,,20000,,Deposito,
66,BBVA,16/12/2024,C07 DEP.CHEQUES DE OTRO BANCO,,176900,,Deposito,
67,BBVA,16/12/2024,C07 DEP.CHEQUES DE OTRO BANCO,,34220,,Deposito,
68,BBVA,16/12/2024,T20 SPEI RECIBIDOSANTANDER,,5568,,Deposito,
69,BBVA,16/12/2024,T20 SPEI RECIBIDOBANAMEX,,19720,,Deposito,
70,BBVA,16/12/2024,W02 DEPOSITO DE TERCERO,,12992,,Deposito,
71,BBVA,16/12/2024,W02 DEPOSITO DE TERCERO,,17400,,Deposito,
72,BBVA,16/12/2024,H09 COBRO AUTOMATICO RECIBO,,13645.2,,Retiro,
73,BBVA,17/12/2024,N06 PAGO CUENTA DE TERCERO,,8932,,Deposito,
74,BBVA,17/12/2024,N03 TRASPASO CUENTAS PROPIAS,,21634.4,,Retiro,
75,BBVA,17/12/2024,N03 TRASPASO CUENTAS PROPIAS,,5800,,Retiro,
76,BBVA,17/12/2024,T20 SPEI RECIBIDOBANREGIO,,46400,,Deposito,
77,BBVA,17/12/2024,T20 SPEI RECIBIDOBANREGIO,,46400,,Deposito,
78,BBVA,17/12/2024,N03 TRASPASO CUENTAS PROPIAS,,11600,,Retiro,
79,BBVA,17/12/2024,T17 SPEI ENVIADO BANORTE,,18096,,Retiro,
80,BBVA,17/12/2024,T17 SPEI ENVIADO BANORTE,,38604.8,,Retiro,
81,BBVA,17/12/2024,N06 PAGO CUENTA DE TERCERO,,14974.9,,Retiro,
82,BBVA,17/12/2024,N03 TRASPASO CUENTAS PROPIAS,,16167,,Retiro,
83,BBVA,17/12/2024,N06 PAGO CUENTA DE TERCERO,,756.5,,Retiro,
84,BBVA,17/12/2024,N06 PAGO CUENTA DE TERCERO,,50000,,Retiro,
85,BBVA,17/12/2024,N06 PAGO CUENTA DE TERCERO,,15438.6,,Retiro,
86,BBVA,17/12/2024,T17 SPEI ENVIADO BAJIO,,28000,,Retiro,
87,BBVA,18/12/2024,W02 DEPOSITO DE TERCERO,,9280,,Deposito,
88,BBVA,18/12/2024,N06 PAGO CUENTA DE TERCERO,,23200,,Deposito,
89,BBVA,18/12/2024,T20 SPEI RECIBIDOAFIRME,,6960,,Deposito,
90,BBVA,18/12/2024,T20 SPEI RECIBIDOAFIRME,,4640,,Deposito,
91,BBVA,19/12/2024,W02 DEPOSITO DE TERCERO,,27997.8,,Deposito,
92,BBVA,19/12/2024,T20 SPEI RECIBIDOSCOTIABANK,,19720,,Deposito,
93,BBVA,19/12/2024,N03 TRASPASO CUENTAS PROPIAS,,5599.17,,Retiro,
94,BBVA,19/12/2024,N03 TRASPASO CUENTAS PROPIAS,,786.72,,Retiro,
95,BBVA,19/12/2024,N03 TRASPASO CUENTAS PROPIAS,,5082.97,,Retiro,
96,BBVA,19/12/2024,N03 TRASPASO CUENTAS PROPIAS,,786.72,,Retiro,
97,BBVA,19/12/2024,W02 DEPOSITO DE TERCERO,,15590.4,,Deposito,
98,BBVA,19/12/2024,W02 DEPOSITO DE TERCERO,,2436,,Deposito,
99,BBVA,19/12/2024,P14 GRUPO NACIONAL PROVI,,21513.2,,Retiro,
100,BBVA,19/12/2024,N06 PAGO CUENTA DE TERCERO,,6088.87,,Retiro,
101,BBVA,19/12/2024,N06 PAGO CUENTA DE TERCERO,,22504,,Deposito,
102,BBVA,19/12/2024,N06 PAGO CUENTA DE TERCERO,,52200,,Deposito,
103,BBVA,19/12/2024,W02 DEPOSITO DE TERCERO,,34800,,Deposito,
104,BBVA,19/12/2024,W02 DEPOSITO DE TERCERO,,58000,,Deposito,
105,BBVA,19/12/2024,TK7 SITB2PAGO FACTURA A 2772,,9280,,Deposito,
106,BBVA,19/12/2024,TK7 SITB2PAGO FACTURA A 2771,,3955.6,,Deposito,
107,BBVA,19/12/2024,N06 PAGO CUENTA DE TERCERO,,41633.3,,Retiro,
108,BBVA,19/12/2024,N06 PAGO CUENTA DE TERCERO,,52041.5,,Retiro,
109,BBVA,20/12/2024,P14 AMERICAN EXPRESS,,31057.4,,Retiro,
110,BBVA,20/12/2024,N03 TRASPASO CUENTAS PROPIAS,,107560,,Retiro,
111,BBVA,20/12/2024,N06 PAGO CUENTA DE TERCERO,,19720,,Deposito,
112,BBVA,20/12/2024,W02 DEPOSITO DE TERCERO,,10440,,Deposito,
113,BBVA,20/12/2024,W02 DEPOSITO DE TERCERO,,13050,,Deposito,
114,BBVA,20/12/2024,W02 DEPOSITO DE TERCERO,,6844,,Deposito,
115,BBVA,20/12/2024,T20 SPEI RECIBIDOBAJIO,,9280,,Deposito,
116,BBVA,23/12/2024,N06 PAGO CUENTA DE TERCERO,,23200,,Deposito,
117,BBVA,23/12/2024,N03 TRASPASO CUENTAS PROPIAS,,48787,,Retiro,
118,BBVA,23/12/2024,N06 PAGO CUENTA DE TERCERO,,2100,,Retiro,
119,BBVA,23/12/2024,N03 TRASPASO CUENTAS PROPIAS,,885,,Retiro,
120,BBVA,23/12/2024,T20 SPEI RECIBIDOBANORTE,,4060,,Deposito,
121,BBVA,23/12/2024,W02 DEPOSITO DE TERCERO,,8120,,Deposito,
122,BBVA,24/12/2024,T20 SPEI RECIBIDOBANORTE,,2320,,Deposito,
123,BBVA,26/12/2024,P14 BEPENSA LEASING SA D,,115068,,Retiro,
124,BBVA,26/12/2024,T20 SPEI RECIBIDOBANORTE,,502667,,Deposito,
125,BBVA,26/12/2024,N03 TRASPASO CUENTAS PROPIAS,,71719.3,,Retiro,
126,BBVA,26/12/2024,N06 PAGO CUENTA DE TERCERO,,299280,,Retiro,
127,BBVA,26/12/2024,T17 SPEI ENVIADO BANORTE,,38604.8,,Retiro,
128,BBVA,26/12/2024,T17 SPEI ENVIADO BANORTE,,18096,,Retiro,
129,BBVA,26/12/2024,N06 PAGO CUENTA DE TERCERO,,31498.9,,Retiro,
130,BBVA,26/12/2024,T17 SPEI ENVIADO SCOTIABANK,,45407.6,,Retiro,
131,BBVA,26/12/2024,T17 SPEI ENVIADO SANTANDER,,58000,,Retiro,
132,BBVA,26/12/2024,T22 SPEI DEVUELTOSANTANDER,,58000,,Deposito,
133,BBVA,26/12/2024,N03 TRASPASO CUENTAS PROPIAS,,82744.5,,Retiro,
134,BBVA,26/12/2024,N06 PAGO CUENTA DE TERCERO,,9817.05,,Retiro,
135,BBVA,26/12/2024,T17 SPEI ENVIADO BANORTE,,2204,,Retiro,
136,BBVA,26/12/2024,T17 SPEI ENVIADO BANORTE,,76560,,Retiro,
137,BBVA,26/12/2024,T22 SPEI DEVUELTOBANORTE,,76560,,Deposito,
138,BBVA,26/12/2024,N06 PAGO CUENTA DE TERCERO,,25260,,Retiro,
139,BBVA,26/12/2024,T17 SPEI ENVIADO BANAMEX,,76560,,Retiro,
140,BBVA,26/12/2024,P14 SAT,,4250,,Retiro,
141,BBVA,26/12/2024,P14 SAT,,3507,,Retiro,
142,BBVA,26/12/2024,T17 SPEI ENVIADO BANORTE,,58000,,Retiro,
143,BBVA,26/12/2024,TK7 SITB2MALDONADOF1196,,47560,,Deposito,
144,BBVA,26/12/2024,T20 SPEI RECIBIDOSANTANDER,,3480,,Deposito,
145,BBVA,26/12/2024,TJ3 SITB23825,,24650,,Deposito,
146,BBVA,27/12/2024,N06 PAGO CUENTA DE TERCERO,,9503,,Retiro,
147,BBVA,27/12/2024,N06 PAGO CUENTA DE TERCERO,,9503,,Retiro,
148,BBVA,27/12/2024,W02 DEPOSITO DE TERCERO,,23200,,Deposito,
149,BBVA,27/12/2024,P14 AMERICAN EXPRESS,,122871,,Retiro,
150,BBVA,27/12/2024,T20 SPEI RECIBIDOHSBC,,15660,,Deposito,
151,BBVA,27/12/2024,T20 SPEI RECIBIDOBANORTE,,50000,,Deposito,
152,BBVA,27/12/2024,N06 PAGO CUENTA DE TERCERO,,150000,,Retiro,
153,BBVA,27/12/2024,N06 PAGO CUENTA DE TERCERO,,150000,,Deposito,
154,BBVA,27/12/2024,N06 PAGO CUENTA DE TERCERO,,149640,,Retiro,
155,BBVA,27/12/2024,T20 SPEI RECIBIDOSANTANDER,,11600,,Deposito,
156,BBVA,27/12/2024,N06 PAGO CUENTA DE TERCERO,,78880,,Retiro,
157,BBVA,27/12/2024,T20 SPEI RECIBIDOBANORTE,,3480,,Deposito,
158,BBVA,28/12/2024,W02 DEPOSITO DE TERCERO,,27376,,Deposito,
159,BBVA,30/12/2024,T17 SPEI ENVIADO SCOTIABANK,,10000,,Retiro,
160,BBVA,30/12/2024,T20 SPEI RECIBIDOSCOTIABANK,,2162.63,,Deposito,
161,BBVA,30/12/2024,N06 PAGO CUENTA DE TERCERO,,17110,,Deposito,
162,BBVA,30/12/2024,N06 PAGO CUENTA DE TERCERO,,16000,,Retiro,
163,BBVA,30/12/2024,T17 SPEI ENVIADO STP,,5676.58,,Retiro,
164,BBVA,31/12/2024,T20 SPEI RECIBIDOBANREGIO,,9976,,Deposito,
165,BBVA,31/12/2024,N06 PAGO CUENTA DE TERCERO,,72585.3,,Deposito,
166,BBVA,31/12/2024,N06 PAGO CUENTA DE TERCERO,,65000,,Retiro,
167,BBVA,31/12/2024,T20 SPEI RECIBIDOBANAMEX,,13920,,Deposito,x
168,BBVA,01/11/2024,Z3 CARGO COBRANZA FACILEASIN,,12079.2,,Retiro,
169,BBVA,01/11/2024,T20 SPEI RECIBIDOBANAMEX,,12180,,Deposito,
170,BBVA,01/11/2024,T20 SPEI RECIBIDOBANAMEX,,13920,,Deposito,
171,BBVA,04/11/2024,W02 DEPOSITO DE TERCERO,,34800,,Deposito,
172,BBVA,04/11/2024,N06 PAGO CUENTA DE TERCERO,,42000,,Retiro,
173,BBVA,05/11/2024,T09 TEF RECIBIDO BANORTE,,12180,,Deposito,
174,BBVA,05/11/2024,N06 PAGO CUENTA DE TERCERO,,3480,,Deposito,
175,BBVA,05/11/2024,N06 PAGO CUENTA DE TERCERO,,27550,,Deposito,
176,BBVA,05/11/2024,P14 AMERICAN EXPRESS,,15830.5,,Retiro,
177,BBVA,06/11/2024,W02 DEPOSITO DE TERCERO,,13340,,Deposito,
178,BBVA,06/11/2024,T20 SPEI RECIBIDOSCOTIABANK,,19720,,Deposito,
179,BBVA,06/11/2024,N03 TRASPASO CUENTAS PROPIAS,,6000,,Retiro,
180,BBVA,06/11/2024,N06 PAGO CUENTA DE TERCERO,,15612.5,,Retiro,
181,BBVA,07/11/2024,W02 DEPOSITO DE TERCERO,,30160,,Deposito,
182,BBVA,07/11/2024,W02 DEPOSITO DE TERCERO,,9280,,Deposito,
183,BBVA,07/11/2024,W02 DEPOSITO DE TERCERO,,81200,,Deposito,
184,BBVA,07/11/2024,T17 SPEI ENVIADO BANAMEX,,7675.44,,Retiro,
185,BBVA,07/11/2024,N06 PAGO CUENTA DE TERCERO,,990,,Retiro,
186,BBVA,08/11/2024,T20 SPEI RECIBIDOBANORTE,,27966.3,,Deposito,
187,BBVA,08/11/2024,N03 TRASPASO CUENTAS PROPIAS,,4516.8,,Retiro,
188,BBVA,08/11/2024,W02 DEPOSITO DE TERCERO,,27840,,Deposito,
189,BBVA,08/11/2024,N03 TRASPASO CUENTAS PROPIAS,,4516.8,,Retiro,
190,BBVA,08/11/2024,T20 SPEI RECIBIDOSANTANDER,,3480,,Deposito,
191,BBVA,10/11/2024,N06 PAGO CUENTA DE TERCERO,,8932,,Deposito,
192,BBVA,11/11/2024,N02 PAGO TARJETA DE CREDITO,,12135.6,,Retiro,
193,BBVA,11/11/2024,T17 SPEI ENVIADO BANAMEX,,5757.76,,Retiro,
194,BBVA,11/11/2024,T17 SPEI ENVIADO BANAMEX,,5757.76,,Retiro,
195,BBVA,11/11/2024,T17 SPEI ENVIADO BANAMEX,,5757.76,,Retiro,
196,BBVA,11/11/2024,N03 TRASPASO CUENTAS PROPIAS,,22058.4,,Retiro,
197,BBVA,11/11/2024,N03 TRASPASO CUENTAS PROPIAS,,22058.4,,Retiro,
198,BBVA,11/11/2024,N03 TRASPASO CUENTAS PROPIAS,,11743.2,,Retiro,
199,BBVA,11/11/2024,N03 TRASPASO CUENTAS PROPIAS,,10293.2,,Retiro,
200,BBVA,11/11/2024,T17 SPEI ENVIADO BANORTE,,1200,,Retiro,
201,BBVA,11/11/2024,N06 PAGO CUENTA DE TERCERO,,6380,,Deposito,
202,BBVA,12/11/2024,N06 PAGO CUENTA DE TERCERO,,1924,,Retiro,
203,BBVA,12/11/2024,N06 PAGO CUENTA DE TERCERO,,19720,,Deposito,
204,BBVA,13/11/2024,N06 PAGO CUENTA DE TERCERO,,25000,,Deposito,
205,BBVA,13/11/2024,T20 SPEI RECIBIDOBANORTE,,20000,,Deposito,
206,BBVA,13/11/2024,N03 TRASPASO CUENTAS PROPIAS,,88828.7,,Retiro,
207,BBVA,13/11/2024,T20 SPEI RECIBIDOBANAMEX,,26100,,Deposito,
208,BBVA,13/11/2024,T20 SPEI RECIBIDOSANTANDER,,9280,,Deposito,
209,BBVA,13/11/2024,N06 PAGO CUENTA DE TERCERO,,3480,,Deposito,
210,BBVA,13/11/2024,N03 TRASPASO CUENTAS PROPIAS,,70879.7,,Retiro,
211,BBVA,13/11/2024,N03 TRASPASO CUENTAS PROPIAS,,5258.03,,Retiro,
212,BBVA,13/11/2024,N03 TRASPASO CUENTAS PROPIAS,,1170.36,,Retiro,
213,BBVA,14/11/2024,T09 TEF RECIBIDO BANORTE,,3955.6,,Deposito,
214,BBVA,14/11/2024,T09 TEF RECIBIDO BANORTE,,9280,,Deposito,
215,BBVA,14/11/2024,W02 DEPOSITO DE TERCERO,,22011,,Deposito,
216,BBVA,14/11/2024,W02 DEPOSITO DE TERCERO,,32282.8,,Deposito,
217,BBVA,14/11/2024,W02 DEPOSITO DE TERCERO,,5359.2,,Deposito,
218,BBVA,14/11/2024,W02 DEPOSITO DE TERCERO,,2679.6,,Deposito,
219,BBVA,14/11/2024,W02 DEPOSITO DE TERCERO,,5359.2,,Deposito,
220,BBVA,14/11/2024,W02 DEPOSITO DE TERCERO,,13015.2,,Deposito,
221,BBVA,14/11/2024,W02 DEPOSITO DE TERCERO,,45240,,Deposito,
222,BBVA,14/11/2024,W02 DEPOSITO DE TERCERO,,43326,,Deposito,
223,BBVA,14/11/2024,BT2 TRANSFER BBVA 00797189 L,,13572,,Deposito,
224,BBVA,14/11/2024,T20 SPEI RECIBIDOSANTANDER,,11600,,Deposito,
225,BBVA,14/11/2024,N03 TRASPASO CUENTAS PROPIAS,,83520,,Deposito,
226,BBVA,14/11/2024,T20 SPEI RECIBIDOSANTANDER,,127328,,Deposito,
227,BBVA,14/11/2024,N06 PAGO CUENTA DE TERCERO,,25000,,Retiro,
228,BBVA,14/11/2024,N03 TRASPASO CUENTAS PROPIAS,,94936.1,,Retiro,
229,BBVA,14/11/2024,N03 TRASPASO CUENTAS PROPIAS,,9082.06,,Retiro,
230,BBVA,14/11/2024,N06 PAGO CUENTA DE TERCERO,,3480,,Deposito,
231,BBVA,14/11/2024,N06 PAGO CUENTA DE TERCERO,,3480,,Deposito,
232,BBVA,14/11/2024,W02 DEPOSITO DE TERCERO,,23200,,Deposito,
233,BBVA,14/11/2024,TK7 SITB2F1146MALDONADOVILLAS,,29000,,Deposito,
234,BBVA,14/11/2024,T20 SPEI RECIBIDOBANAMEX,,19720,,Deposito,
235,BBVA,15/11/2024,N03 TRASPASO CUENTAS PROPIAS,,14167,,Retiro,
236,BBVA,15/11/2024,N06 PAGO CUENTA DE TERCERO,,9817.05,,Retiro,
237,BBVA,15/11/2024,T17 SPEI ENVIADO HSBC,,6655.5,,Retiro,
238,BBVA,15/11/2024,N03 TRASPASO CUENTAS PROPIAS,,56043.4,,Retiro,
239,BBVA,15/11/2024,W02 DEPOSITO DE TERCERO,,25520,,Deposito,
240,BBVA,15/11/2024,H09 COBRO AUTOMATICO RECIBO,,13645.2,,Retiro,
241,BBVA,19/11/2024,N06 PAGO CUENTA DE TERCERO,,81200,,Retiro,
242,BBVA,19/11/2024,N03 TRASPASO CUENTAS PROPIAS,,52200,,Deposito,
243,BBVA,19/11/2024,N03 TRASPASO CUENTAS PROPIAS,,5073.41,,Retiro,
244,BBVA,19/11/2024,N03 TRASPASO CUENTAS PROPIAS,,14167,,Retiro,
245,BBVA,19/11/2024,W02 DEPOSITO DE TERCERO,,29000,,Deposito,
246,BBVA,19/11/2024,T17 SPEI ENVIADO SCOTIABANK,,7000,,Retiro,
247,BBVA,19/11/2024,N06 PAGO CUENTA DE TERCERO,,4640,,Retiro,
248,BBVA,19/11/2024,W02 DEPOSITO DE TERCERO,,63800,,Deposito,
249,BBVA,20/11/2024,N06 PAGO CUENTA DE TERCERO,,15950.1,,Retiro,
250,BBVA,20/11/2024,N03 TRASPASO CUENTAS PROPIAS,,14650.8,,Retiro,
251,BBVA,21/11/2024,N03 TRASPASO CUENTAS PROPIAS,,1108.78,,Retiro,
252,BBVA,21/11/2024,N03 TRASPASO CUENTAS PROPIAS,,5589.61,,Retiro,
253,BBVA,21/11/2024,N06 PAGO CUENTA DE TERCERO,,13256.4,,Retiro,
254,BBVA,22/11/2024,N06 PAGO CUENTA DE TERCERO,,11800,,Retiro,
255,BBVA,22/11/2024,T20 SPEI RECIBIDOBANORTE,,9280,,Deposito,
256,BBVA,22/11/2024,T20 SPEI RECIBIDOSANTANDER,,5800,,Deposito,
257,BBVA,22/11/2024,T20 SPEI RECIBIDOSANTANDER,,5800,,Deposito,
258,BBVA,22/11/2024,T20 SPEI RECIBIDOBANORTE,,269733,,Deposito,
259,BBVA,22/11/2024,W02 DEPOSITO DE TERCERO,,34800,,Deposito,
260,BBVA,22/11/2024,W02 DEPOSITO DE TERCERO,,13050,,Deposito,
261,BBVA,22/11/2024,W02 DEPOSITO DE TERCERO,,6844,,Deposito,
262,BBVA,22/11/2024,N06 PAGO CUENTA DE TERCERO,,16806,,Retiro,
263,BBVA,23/11/2024,N06 PAGO CUENTA DE TERCERO,,6090,,Deposito,
264,BBVA,23/11/2024,W02 DEPOSITO DE TERCERO,,23200,,Deposito,
265,BBVA,23/11/2024,W02 DEPOSITO DE TERCERO,,11600,,Deposito,
266,BBVA,25/11/2024,T20 SPEI RECIBIDOBANORTE,,3480,,Deposito,
267,BBVA,25/11/2024,N06 PAGO CUENTA DE TERCERO,,50000,,Retiro,
268,BBVA,25/11/2024,N06 PAGO CUENTA DE TERCERO,,62449.8,,Retiro,
269,BBVA,25/11/2024,N06 PAGO CUENTA DE TERCERO,,299280,,Retiro,
270,BBVA,25/11/2024,N03 TRASPASO CUENTAS PROPIAS,,63032,,Retiro,
271,BBVA,25/11/2024,N03 TRASPASO CUENTAS PROPIAS,,87202,,Retiro,
272,BBVA,25/11/2024,N06 PAGO CUENTA DE TERCERO,,20000,,Retiro,
273,BBVA,25/11/2024,W02 DEPOSITO DE TERCERO,,5104,,Deposito,
274,BBVA,25/11/2024,N06 PAGO CUENTA DE TERCERO,,3828,,Deposito,
275,BBVA,25/11/2024,N06 PAGO CUENTA DE TERCERO,,22504,,Deposito,
276,BBVA,25/11/2024,T20 SPEI RECIBIDOSANTANDER,,5568,,Deposito,
277,BBVA,25/11/2024,T20 SPEI RECIBIDOBANORTE,,2320,,Deposito,
278,BBVA,26/11/2024,T20 SPEI RECIBIDOBANREGIO,,9976,,Deposito,
279,BBVA,26/11/2024,T20 SPEI RECIBIDOSANTANDER,,24360,,Deposito,
280,BBVA,26/11/2024,T20 SPEI RECIBIDOAFIRME,,26100,,Deposito,
281,BBVA,26/11/2024,N06 PAGO CUENTA DE TERCERO,,13200,,Deposito,
282,BBVA,27/11/2024,W02 DEPOSITO DE TERCERO,,24128,,Deposito,
283,BBVA,27/11/2024,T20 SPEI RECIBIDOHSBC,,26912,,Deposito,
284,BBVA,27/11/2024,N03 TRASPASO CUENTAS PROPIAS,,70879.8,,Retiro,
285,BBVA,27/11/2024,N03 TRASPASO CUENTAS PROPIAS,,94175.9,,Retiro,
286,BBVA,27/11/2024,N06 PAGO CUENTA DE TERCERO,,720,,Deposito,
287,BBVA,28/11/2024,N03 TRASPASO CUENTAS PROPIAS,,884.33,,Retiro,
288,BBVA,28/11/2024,T20 SPEI RECIBIDOSCOTIABANK,,2162.63,,Deposito,
289,BBVA,28/11/2024,T17 SPEI ENVIADO BANORTE,,18096,,Retiro,
290,BBVA,28/11/2024,N03 TRASPASO CUENTAS PROPIAS,,38604.8,,Retiro,
291,BBVA,28/11/2024,N06 PAGO CUENTA DE TERCERO,,9817.05,,Retiro,
292,BBVA,28/11/2024,N03 TRASPASO CUENTAS PROPIAS,,10393.6,,Retiro,
293,BBVA,28/11/2024,N03 TRASPASO CUENTAS PROPIAS,,884.33,,Retiro,
294,BBVA,28/11/2024,T17 SPEI ENVIADO BANORTE,,2204,,Retiro,
295,BBVA,28/11/2024,T17 SPEI ENVIADO STP,,5676.58,,Retiro,
296,BBVA,28/11/2024,W02 DEPOSITO DE TERCERO,,15590.4,,Deposito,
297,BBVA,28/11/2024,W02 DEPOSITO DE TERCERO,,2436,,Deposito,
298,BBVA,28/11/2024,P14 SAT,,5556,,Retiro,
299,BBVA,28/11/2024,P14 SAT,,5650,,Retiro,
300,BBVA,28/11/2024,W02 DEPOSITO DE TERCERO,,11020,,Deposito,
301,BBVA,28/11/2024,N06 PAGO CUENTA DE TERCERO,,6380,,Deposito,
302,BBVA,29/11/2024,N06 PAGO CUENTA DE TERCERO,,8932,,Deposito,
303,BBVA,29/11/2024,W02 DEPOSITO DE TERCERO,,24128,,Deposito,
304,BBVA,29/11/2024,N03 TRASPASO CUENTAS PROPIAS,,342,,Deposito,
305,BBVA,29/11/2024,T20 SPEI RECIBIDOHSBC,,15660,,Deposito,
306,BBVA,29/11/2024,T20 SPEI RECIBIDOBANAMEX,,12180,,Deposito,
307,BBVA,29/11/2024,T20 SPEI RECIBIDOBANAMEX,,13920,,Deposito,
308,BBVA,29/11/2024,W02 DEPOSITO DE TERCERO,,27840,,Deposito,
309,BBVA,29/11/2024,W02 DEPOSITO DE TERCERO,,8120,,Deposito,
310,BBVA,29/11/2024,N06 PAGO CUENTA DE TERCERO,,24786,,Retiro,
311,BBVA,29/11/2024,N06 PAGO CUENTA DE TERCERO,,201650,,Retiro,
312,BBVA,29/11/2024,N06 PAGO CUENTA DE TERCERO,,52200,,Deposito,
313,BBVA,29/11/2024,N06 PAGO CUENTA DE TERCERO,,52200,,Retiro,
314,BBVA,02/10/2024,Z3 CARGO COBRANZA FACILEASIN,,12079.2,,Retiro,
315,BBVA,03/10/2024,T20 SPEI RECIBIDOSCOTIABANK,,2838.29,,Deposito,
316,BBVA,04/10/2024,T09 TEF RECIBIDO BANORTE,,12180,,Deposito,
317,BBVA,04/10/2024,N03 TRASPASO CUENTAS PROPIAS,,2796.36,,Retiro,
318,BBVA,04/10/2024,N03 TRASPASO CUENTAS PROPIAS,,2796.36,,Retiro,
319,BBVA,04/10/2024,W02 DEPOSITO DE TERCERO,,27840,,Deposito,
320,BBVA,07/10/2024,N03 TRASPASO CUENTAS PROPIAS,,1000000,,Deposito,
321,BBVA,07/10/2024,N06 PAGO CUENTA DE TERCERO,,90000,,Retiro,
322,BBVA,07/10/2024,P14 AMERICAN EXPRESS,,25377.2,,Retiro,
323,BBVA,07/10/2024,T17 SPEI ENVIADO SCOTIABANK,,6000,,Retiro,
324,BBVA,08/10/2024,N06 PAGO CUENTA DE TERCERO,,900000,,Retiro,
325,BBVA,08/10/2024,N06 PAGO CUENTA DE TERCERO,,2320,,Retiro,
326,BBVA,08/10/2024,T20 SPEI RECIBIDOSANTANDER,,91872,,Deposito,
327,BBVA,08/10/2024,T20 SPEI RECIBIDOAFIRME,,26100,,Deposito,
328,BBVA,08/10/2024,T20 SPEI RECIBIDOBAJIO,,9280,,Deposito,
329,BBVA,09/10/2024,N06 PAGO CUENTA DE TERCERO,,19720,,Deposito,
330,BBVA,09/10/2024,T17 SPEI ENVIADO BANORTE,,18096,,Retiro,
331,BBVA,09/10/2024,T17 SPEI ENVIADO BANORTE,,38604.8,,Retiro,
332,BBVA,09/10/2024,N03 TRASPASO CUENTAS PROPIAS,,14117.8,,Retiro,
333,BBVA,09/10/2024,T20 SPEI RECIBIDOBANAMEX,,19720,,Deposito,
334,BBVA,10/10/2024,T09 TEF RECIBIDO BANORTE,,3955.6,,Deposito,
335,BBVA,10/10/2024,T09 TEF RECIBIDO BANORTE,,9280,,Deposito,
336,BBVA,10/10/2024,W02 DEPOSITO DE TERCERO,,5104,,Deposito,
337,BBVA,10/10/2024,W02 DEPOSITO DE TERCERO,,23200,,Deposito,
338,BBVA,10/10/2024,N06 PAGO CUENTA DE TERCERO,,43384,,Deposito,
339,BBVA,10/10/2024,N06 PAGO CUENTA DE TERCERO,,43384,,Deposito,
340,BBVA,10/10/2024,W02 DEPOSITO DE TERCERO,,70372.6,,Deposito,
341,BBVA,10/10/2024,N03 TRASPASO CUENTAS PROPIAS,,10288.8,,Retiro,
342,BBVA,10/10/2024,N06 PAGO CUENTA DE TERCERO,,3480,,Deposito,
343,BBVA,10/10/2024,W02 DEPOSITO DE TERCERO,,22011,,Deposito,
344,BBVA,10/10/2024,W02 DEPOSITO DE TERCERO,,32282.8,,Deposito,
345,BBVA,10/10/2024,W02 DEPOSITO DE TERCERO,,45240,,Deposito,
346,BBVA,10/10/2024,W02 DEPOSITO DE TERCERO,,43326,,Deposito,
347,BBVA,10/10/2024,W02 DEPOSITO DE TERCERO,,13015.2,,Deposito,
348,BBVA,10/10/2024,W02 DEPOSITO DE TERCERO,,5359.2,,Deposito,
349,BBVA,10/10/2024,W02 DEPOSITO DE TERCERO,,2679.6,,Deposito,
350,BBVA,10/10/2024,W02 DEPOSITO DE TERCERO,,5359.2,,Deposito,
351,BBVA,11/10/2024,N03 TRASPASO CUENTAS PROPIAS,,89995.1,,Retiro,
352,BBVA,11/10/2024,BT2 TRANSFER BBVA 00797189 L,,13572,,Deposito,
353,BBVA,11/10/2024,W02 DEPOSITO DE TERCERO,,9280,,Deposito,
354,BBVA,11/10/2024,W02 DEPOSITO DE TERCERO,,25520,,Deposito,
355,BBVA,11/10/2024,N03 TRASPASO CUENTAS PROPIAS,,70879.8,,Retiro,
356,BBVA,11/10/2024,N06 PAGO CUENTA DE TERCERO,,23200,,Deposito,
357,BBVA,12/10/2024,W02 DEPOSITO DE TERCERO,,9280,,Deposito,
358,BBVA,14/10/2024,T20 SPEI RECIBIDOBANAMEX,,26100,,Deposito,
359,BBVA,14/10/2024,T20 SPEI RECIBIDOSANTANDER,,9280,,Deposito,
360,BBVA,14/10/2024,W02 DEPOSITO DE TERCERO,,13340,,Deposito,
361,BBVA,14/10/2024,N06 PAGO CUENTA DE TERCERO,,400,,Retiro,
362,BBVA,15/10/2024,T20 SPEI RECIBIDOSANTANDER,,81200,,Deposito,
363,BBVA,15/10/2024,P14 QUALITAS COMPANIA DE,,11601,,Retiro,
364,BBVA,15/10/2024,H09 COBRO AUTOMATICO RECIBO,,13645.2,,Retiro,
365,BBVA,16/10/2024,N06 PAGO CUENTA DE TERCERO,,400,,Retiro,
366,BBVA,16/10/2024,N03 TRASPASO CUENTAS PROPIAS,,28931.9,,Retiro,
367,BBVA,16/10/2024,N03 TRASPASO CUENTAS PROPIAS,,21083.1,,Retiro,
368,BBVA,16/10/2024,T17 SPEI ENVIADO SCOTIABANK,,52200,,Retiro,
369,BBVA,16/10/2024,N06 PAGO CUENTA DE TERCERO,,11818.1,,Retiro,
370,BBVA,17/10/2024,T09 TEF RECIBIDO BANORTE,,9280,,Deposito,
371,BBVA,17/10/2024,N06 PAGO CUENTA DE TERCERO,,3828,,Deposito,
372,BBVA,17/10/2024,N06 PAGO CUENTA DE TERCERO,,9817.05,,Retiro,
373,BBVA,17/10/2024,W02 DEPOSITO DE TERCERO,,2436,,Deposito,
374,BBVA,17/10/2024,N06 PAGO CUENTA DE TERCERO,,6090,,Deposito,
375,BBVA,17/10/2024,T20 SPEI RECIBIDOSANTANDER,,5568,,Deposito,
376,BBVA,17/10/2024,N03 TRASPASO CUENTAS PROPIAS,,114840,,Deposito,
377,BBVA,17/10/2024,TK7 SITB2MALDONADOFACTB1127,,29000,,Deposito,
378,BBVA,18/10/2024,T17 SPEI ENVIADO SCOTIABANK,,8000,,Retiro,
379,BBVA,18/10/2024,W02 DEPOSITO DE TERCERO,,21750,,Deposito,
380,BBVA,18/10/2024,N06 PAGO CUENTA DE TERCERO,,22504,,Deposito,
381,BBVA,21/10/2024,W02 DEPOSITO DE TERCERO,,11600,,Deposito,
382,BBVA,21/10/2024,W02 DEPOSITO DE TERCERO,,71050,,Deposito,
383,BBVA,21/10/2024,N06 PAGO CUENTA DE TERCERO,,3480,,Deposito,
384,BBVA,21/10/2024,N03 TRASPASO CUENTAS PROPIAS,,58061.8,,Retiro,
385,BBVA,21/10/2024,N03 TRASPASO CUENTAS PROPIAS,,83169.5,,Retiro,
386,BBVA,21/10/2024,T17 SPEI ENVIADO BANORTE,,38604.8,,Retiro,
387,BBVA,21/10/2024,N06 PAGO CUENTA DE TERCERO,,8990,,Retiro,
388,BBVA,21/10/2024,N03 TRASPASO CUENTAS PROPIAS,,18096,,Retiro,
389,BBVA,21/10/2024,P14 SAT,,5475,,Retiro,
390,BBVA,21/10/2024,P14 SAT,,4960,,Retiro,
391,BBVA,21/10/2024,N06 PAGO CUENTA DE TERCERO,,12180.2,,Retiro,
392,BBVA,22/10/2024,N06 PAGO CUENTA DE TERCERO,,13920,,Deposito,
393,BBVA,23/10/2024,T20 SPEI RECIBIDOBANORTE,,2320,,Deposito,
394,BBVA,23/10/2024,N06 PAGO CUENTA DE TERCERO,,2320,,Deposito,
395,BBVA,23/10/2024,T20 SPEI RECIBIDOSANTANDER,,11600,,Deposito,
396,BBVA,23/10/2024,N06 PAGO CUENTA DE TERCERO,,23200,,Deposito,
397,BBVA,23/10/2024,N03 TRASPASO CUENTAS PROPIAS,,87495.2,,Retiro,
398,BBVA,23/10/2024,N03 TRASPASO CUENTAS PROPIAS,,70879.8,,Retiro,
399,BBVA,24/10/2024,W02 DEPOSITO DE TERCERO,,10440,,Deposito,
400,BBVA,24/10/2024,T20 SPEI RECIBIDOBANORTE,,12180,,Deposito,
401,BBVA,25/10/2024,T20 SPEI RECIBIDOBANREGIO,,9976,,Deposito,
402,BBVA,25/10/2024,W02 DEPOSITO DE TERCERO,,383960,,Deposito,
403,BBVA,25/10/2024,W02 DEPOSITO DE TERCERO,,69600,,Deposito,
404,BBVA,25/10/2024,T20 SPEI RECIBIDOHSBC,,26912,,Deposito,
405,BBVA,25/10/2024,N06 PAGO CUENTA DE TERCERO,,4495,,Retiro,
406,BBVA,25/10/2024,N06 PAGO CUENTA DE TERCERO,,14635,,Retiro,
407,BBVA,28/10/2024,N06 PAGO CUENTA DE TERCERO,,37867.5,,Retiro,
408,BBVA,28/10/2024,N06 PAGO CUENTA DE TERCERO,,93675,,Retiro,
409,BBVA,28/10/2024,N06 PAGO CUENTA DE TERCERO,,27550,,Deposito,
410,BBVA,28/10/2024,N03 TRASPASO CUENTAS PROPIAS,,10000,,Retiro,
411,BBVA,28/10/2024,N06 PAGO CUENTA DE TERCERO,,5070,,Retiro,
412,BBVA,28/10/2024,T20 SPEI RECIBIDOBANREGIO,,46400,,Deposito,
413,BBVA,29/10/2024,T17 SPEI ENVIADO SANTANDER,,46400,,Retiro,
414,BBVA,29/10/2024,T17 SPEI ENVIADO INBURSA,,29000,,Retiro,
415,BBVA,29/10/2024,T17 SPEI ENVIADO SCOTIABANK,,83520,,Retiro,
416,BBVA,29/10/2024,T17 SPEI ENVIADO SCOTIABANK,,46890.3,,Retiro,
417,BBVA,29/10/2024,T20 SPEI RECIBIDOSANTANDER,,17400,,Deposito,
418,BBVA,29/10/2024,N06 PAGO CUENTA DE TERCERO,,452400,,Retiro,
419,BBVA,29/10/2024,N06 PAGO CUENTA DE TERCERO,,9817.05,,Retiro,
420,BBVA,29/10/2024,P14 TELCEL,,449,,Retiro,
421,BBVA,29/10/2024,T20 SPEI RECIBIDOBANORTE,,3480,,Deposito,
422,BBVA,30/10/2024,T20 SPEI RECIBIDOSCOTIABANK,,1486.97,,Deposito,
423,BBVA,30/10/2024,T17 SPEI ENVIADO SANTANDER,,80821.3,,Retiro,
424,BBVA,30/10/2024,P14 AMERICAN EXPRESS,,14769.1,,Retiro,
425,BBVA,30/10/2024,N03 TRASPASO CUENTAS PROPIAS,,663.78,,Retiro,
426,BBVA,30/10/2024,T17 SPEI ENVIADO STP,,5676.58,,Retiro,
427,BBVA,30/10/2024,T17 SPEI ENVIADO BANORTE,,2204,,Retiro,
428,BBVA,31/10/2024,N03 TRASPASO CUENTAS PROPIAS,,342,,Deposito,
429,BBVA,31/10/2024,W02 DEPOSITO DE TERCERO,,40600,,Deposito,
430,BBVA,31/10/2024,N06 PAGO CUENTA DE TERCERO,,42000,,Deposito,
431,BBVA,31/10/2024,T17 SPEI ENVIADO BANORTE,,80821.3,,Retiro,
432,BBVA,31/10/2024,W02 DEPOSITO DE TERCERO,,15590.4,,Deposito,
433,BBVA,31/10/2024,N06 PAGO CUENTA DE TERCERO,,73080,,Retiro,
434,BBVA,31/10/2024,T20 SPEI RECIBIDOSCOTIABANK,,19720,,Deposito,
435,BBVA,31/10/2024,T20 SPEI RECIBIDOSANTANDER,,80821.3,,Deposito,
436,BBVA,31/10/2024,T20 SPEI RECIBIDOHSBC,,15660,,Deposito,
437,BBVA,01/02/2024,N06 PAGO CUENTA DE TERCERO,,2900,,Deposito,
438,BBVA,01/02/2024,W02 DEPOSITO DE TERCERO,,23200,,Deposito,
439,BBVA,01/02/2024,W02 DEPOSITO DE TERCERO,,4060,,Deposito,
440,BBVA,01/02/2024,W02 DEPOSITO DE TERCERO,,11600,,Deposito,
441,BBVA,01/02/2024,H09 COBRO AUTOMATICO RECIBO,,1158.63,,Retiro,
442,BBVA,02/02/2024,T20 SPEI RECIBIDOBANORTE,,14500,,Deposito,
443,BBVA,02/02/2024,T20 SPEI RECIBIDOBANORTE,,11600,,Deposito,
444,BBVA,02/02/2024,BT2 TRANSFER BBVA 00797189 L,,12528,,Deposito,
445,BBVA,02/02/2024,N03 TRASPASO CUENTAS PROPIAS,,4061.88,,Retiro,
446,BBVA,02/02/2024,N03 TRASPASO CUENTAS PROPIAS,,4061.88,,Retiro,
447,BBVA,02/02/2024,P14 AMERICAN EXPRESS,,45392.3,,Retiro,
448,BBVA,02/02/2024,N06 PAGO CUENTA DE TERCERO,,10000,,Retiro,
449,BBVA,06/02/2024,W02 DEPOSITO DE TERCERO,,13340,,Deposito,
450,BBVA,06/02/2024,N06 PAGO CUENTA DE TERCERO,,20000,,Retiro,
451,BBVA,06/02/2024,T20 SPEI RECIBIDOBANORTE,,9280,,Deposito,
452,BBVA,06/02/2024,T20 SPEI RECIBIDOSCOTIABANK,,19720,,Deposito,
453,BBVA,06/02/2024,T17 SPEI ENVIADO SCOTIABANK,,10000,,Retiro,
454,BBVA,07/02/2024,S39 SERV BANCA INTERNET,,250,,Retiro,
455,BBVA,07/02/2024,S39 SERV BANCA INTERNET,,130,,Retiro,
456,BBVA,07/02/2024,S40 IVA COM SERV BCA INTERNET,,60.8,,Retiro,
457,BBVA,07/02/2024,N06 PAGO CUENTA DE TERCERO,,146160,,Deposito,
458,BBVA,08/02/2024,W02 DEPOSITO DE TERCERO,,10440,,Deposito,
459,BBVA,08/02/2024,W02 DEPOSITO DE TERCERO,,34336,,Deposito,
460,BBVA,08/02/2024,BT2 TRANSFER BBVA 00841021 L,,7308,,Deposito,
461,BBVA,09/02/2024,N06 PAGO CUENTA DE TERCERO,,23200,,Deposito,
462,BBVA,09/02/2024,W02 DEPOSITO DE TERCERO,,19488,,Deposito,
463,BBVA,09/02/2024,BT2 TRANSFER BBVA 00797189 L,,12528,,Deposito,
464,BBVA,09/02/2024,W02 DEPOSITO DE TERCERO,,25665,,Deposito,
465,BBVA,09/02/2024,W02 DEPOSITO DE TERCERO,,12325,,Deposito,
466,BBVA,09/02/2024,W02 DEPOSITO DE TERCERO,,25520,,Deposito,
467,BBVA,12/02/2024,N06 PAGO CUENTA DE TERCERO,,86062.5,,Retiro,
468,BBVA,12/02/2024,N03 TRASPASO CUENTAS PROPIAS,,61560.8,,Retiro,
469,BBVA,12/02/2024,N03 TRASPASO CUENTAS PROPIAS,,55111.5,,Retiro,
470,BBVA,12/02/2024,W02 DEPOSITO DE TERCERO,,162400,,Deposito,
471,BBVA,12/02/2024,BT2 TRANSFER BBVA 00841021 L,,7308,,Deposito,
472,BBVA,13/02/2024,U05 DEPOSITO DE FIDUCIARIO,,22968,,Deposito,
473,BBVA,13/02/2024,P14 TELCEL,,599,,Retiro,
474,BBVA,13/02/2024,N06 PAGO CUENTA DE TERCERO,,42533.3,,Deposito,
475,BBVA,13/02/2024,T20 SPEI RECIBIDOBANORTE,,22968,,Deposito,
476,BBVA,13/02/2024,T17 SPEI ENVIADO BANORTE,,18096,,Retiro,
477,BBVA,13/02/2024,T17 SPEI ENVIADO BANORTE,,38604.8,,Retiro,
478,BBVA,13/02/2024,N06 PAGO CUENTA DE TERCERO,,1000,,Retiro,
479,BBVA,13/02/2024,T20 SPEI RECIBIDOBANAMEX,,24128,,Deposito,
480,BBVA,13/02/2024,N06 PAGO CUENTA DE TERCERO,,186700,,Retiro,
481,BBVA,13/02/2024,T20 SPEI RECIBIDOSANTANDER,,8816,,Deposito,
482,BBVA,13/02/2024,N06 PAGO CUENTA DE TERCERO,,13340,,Retiro,
483,BBVA,14/02/2024,N06 PAGO CUENTA DE TERCERO,,2000,,Retiro,
484,BBVA,14/02/2024,N06 PAGO CUENTA DE TERCERO,,9817.05,,Retiro,
485,BBVA,14/02/2024,N06 PAGO CUENTA DE TERCERO,,18270,,Deposito,
486,BBVA,14/02/2024,T20 SPEI RECIBIDOSCOTIABANK,,9425,,Deposito,
487,BBVA,14/02/2024,W02 DEPOSITO DE TERCERO,,9744,,Deposito,
488,BBVA,15/02/2024,N06 PAGO CUENTA DE TERCERO,,85000,,Retiro,
489,BBVA,15/02/2024,N06 PAGO CUENTA DE TERCERO,,9317.62,,Retiro,
490,BBVA,15/02/2024,N06 PAGO CUENTA DE TERCERO,,19720,,Deposito,
491,BBVA,15/02/2024,W02 DEPOSITO DE TERCERO,,22011,,Deposito,
492,BBVA,15/02/2024,W02 DEPOSITO DE TERCERO,,32282.8,,Deposito,
493,BBVA,15/02/2024,N06 PAGO CUENTA DE TERCERO,,600,,Retiro,
494,BBVA,15/02/2024,W02 DEPOSITO DE TERCERO,,5359.2,,Deposito,
495,BBVA,15/02/2024,W02 DEPOSITO DE TERCERO,,5359.2,,Deposito,
496,BBVA,15/02/2024,W02 DEPOSITO DE TERCERO,,43326,,Deposito,
497,BBVA,15/02/2024,W02 DEPOSITO DE TERCERO,,2679.6,,Deposito,
498,BBVA,15/02/2024,W02 DEPOSITO DE TERCERO,,13015.2,,Deposito,
499,BBVA,15/02/2024,W02 DEPOSITO DE TERCERO,,18328,,Deposito,
500,BBVA,15/02/2024,W02 DEPOSITO DE TERCERO,,18792,,Deposito,
501,BBVA,15/02/2024,W02 DEPOSITO DE TERCERO,,12296,,Deposito,
502,BBVA,15/02/2024,W02 DEPOSITO DE TERCERO,,13456,,Deposito,
503,BBVA,15/02/2024,N06 PAGO CUENTA DE TERCERO,,1200,,Retiro,
504,BBVA,15/02/2024,N06 PAGO CUENTA DE TERCERO,,7806.25,,Retiro,
505,BBVA,15/02/2024,TK7 SITB2SJMALDONADOB907,,45240,,Deposito,
506,BBVA,15/02/2024,H09 COBRO AUTOMATICO RECIBO,,13645.2,,Retiro,
507,BBVA,16/02/2024,N06 PAGO CUENTA DE TERCERO,,4060,,Retiro,
508,BBVA,16/02/2024,T20 SPEI RECIBIDOSCOTIABANK,,40600,,Deposito,
509,BBVA,16/02/2024,N03 TRASPASO CUENTAS PROPIAS,,17290.2,,Retiro,
510,BBVA,16/02/2024,N03 TRASPASO CUENTAS PROPIAS,,14446.2,,Retiro,
511,BBVA,16/02/2024,W02 DEPOSITO DE TERCERO,,9280,,Deposito,
512,BBVA,16/02/2024,P14 TELCEL,,500,,Retiro,
513,BBVA,16/02/2024,P14 TELCEL,,700,,Retiro,
514,BBVA,19/02/2024,W02 DEPOSITO DE TERCERO,,67280,,Deposito,
515,BBVA,19/02/2024,N03 TRASPASO CUENTAS PROPIAS,,16062.3,,Retiro,
516,BBVA,19/02/2024,N03 TRASPASO CUENTAS PROPIAS,,11869.6,,Retiro,
517,BBVA,19/02/2024,T17 SPEI ENVIADO BANORTE,,2100,,Retiro,
518,BBVA,20/02/2024,T20 SPEI RECIBIDOSANTANDER,,14616,,Deposito,
519,BBVA,20/02/2024,T20 SPEI RECIBIDOSANTANDER,,5568,,Deposito,
520,BBVA,20/02/2024,T20 SPEI RECIBIDOBANREGIO,,9976,,Deposito,
521,BBVA,20/02/2024,N03 TRASPASO CUENTAS PROPIAS,,14616,,Retiro,
522,BBVA,21/02/2024,N06 PAGO CUENTA DE TERCERO,,8932,,Deposito,
523,BBVA,21/02/2024,N06 PAGO CUENTA DE TERCERO,,18270,,Deposito,
524,BBVA,21/02/2024,T20 SPEI RECIBIDOSCOTIABANK,,2023.97,,Deposito,
525,BBVA,21/02/2024,W02 DEPOSITO DE TERCERO,,9744,,Deposito,
526,BBVA,21/02/2024,T17 SPEI ENVIADO HSBC,,13311,,Retiro,
527,BBVA,21/02/2024,N06 PAGO CUENTA DE TERCERO,,575,,Retiro,
528,BBVA,21/02/2024,T20 SPEI RECIBIDOBANAMEX,,12180,,Deposito,
529,BBVA,21/02/2024,N06 PAGO CUENTA DE TERCERO,,6380,,Deposito,
530,BBVA,21/02/2024,T17 SPEI ENVIADO BANORTE,,720,,Retiro,
531,BBVA,21/02/2024,T17 SPEI ENVIADO BANORTE,,18096,,Retiro,
532,BBVA,21/02/2024,T17 SPEI ENVIADO BANORTE,,38604.8,,Retiro,
533,BBVA,22/02/2024,W02 DEPOSITO DE TERCERO,,22968,,Deposito,
534,BBVA,22/02/2024,W02 DEPOSITO DE TERCERO,,19488,,Deposito,
535,BBVA,22/02/2024,W02 DEPOSITO DE TERCERO,,2436,,Deposito,
536,BBVA,22/02/2024,T20 SPEI RECIBIDOHSBC,,3197.25,,Deposito,
537,BBVA,22/02/2024,W02 DEPOSITO DE TERCERO,,7105.58,,Deposito,
538,BBVA,23/02/2024,T09 TEF RECIBIDO BANORTE,,3642.4,,Deposito,
539,BBVA,23/02/2024,T09 TEF RECIBIDO BANORTE,,3642.4,,Deposito,
540,BBVA,23/02/2024,N03 TRASPASO CUENTAS PROPIAS,,20038,,Retiro,
541,BBVA,23/02/2024,N03 TRASPASO CUENTAS PROPIAS,,43535,,Retiro,
542,BBVA,23/02/2024,N03 TRASPASO CUENTAS PROPIAS,,50957.6,,Retiro,
543,BBVA,23/02/2024,N03 TRASPASO CUENTAS PROPIAS,,63036.7,,Retiro,
544,BBVA,23/02/2024,N06 PAGO CUENTA DE TERCERO,,197800,,Retiro,
545,BBVA,23/02/2024,N06 PAGO CUENTA DE TERCERO,,5800,,Deposito,
546,BBVA,23/02/2024,T20 SPEI RECIBIDOBANORTE,,3480,,Deposito,
547,BBVA,26/02/2024,T20 SPEI RECIBIDOSCOTIABANK,,23200,,Deposito,
548,BBVA,26/02/2024,T17 SPEI ENVIADO SCOTIABANK,,15000,,Retiro,
549,BBVA,26/02/2024,N06 PAGO CUENTA DE TERCERO,,2204,,Retiro,
550,BBVA,26/02/2024,N06 PAGO CUENTA DE TERCERO,,75400,,Retiro,
551,BBVA,26/02/2024,N06 PAGO CUENTA DE TERCERO,,6960,,Deposito,
552,BBVA,27/02/2024,T17 SPEI ENVIADO BANORTE,,6000,,Retiro,
553,BBVA,27/02/2024,N06 PAGO CUENTA DE TERCERO,,22504,,Deposito,
554,BBVA,28/02/2024,W02 DEPOSITO DE TERCERO,,9744,,Deposito,
555,BBVA,28/02/2024,N03 TRASPASO CUENTAS PROPIAS,,5000,,Retiro,
556,BBVA,28/02/2024,N03 TRASPASO CUENTAS PROPIAS,,5770.88,,Retiro,
557,BBVA,28/02/2024,T17 SPEI ENVIADO STP,,4226.11,,Retiro,
558,BBVA,28/02/2024,N06 PAGO CUENTA DE TERCERO,,3300,,Retiro,
559,BBVA,28/02/2024,W02 DEPOSITO DE TERCERO,,15590.4,,Deposito,
560,BBVA,28/02/2024,N06 PAGO CUENTA DE TERCERO,,4880,,Retiro,
561,BBVA,28/02/2024,T20 SPEI RECIBIDOBANORTE,,174000,,Deposito,
562,BBVA,28/02/2024,P14 AMERICAN EXPRESS,,4394.02,,Retiro,
563,BBVA,28/02/2024,W02 DEPOSITO DE TERCERO,,5104,,Deposito,
564,BBVA,28/02/2024,N06 PAGO CUENTA DE TERCERO,,3828,,Deposito,
565,BBVA,28/02/2024,W02 DEPOSITO DE TERCERO,,18328,,Deposito,
566,BBVA,28/02/2024,W02 DEPOSITO DE TERCERO,,18792,,Deposito,
567,BBVA,28/02/2024,TK7 SITB2HONORARIOSCONSULTORI,,46400,,Deposito,
568,BBVA,28/02/2024,W02 DEPOSITO DE TERCERO,,13456,,Deposito,
569,BBVA,28/02/2024,W02 DEPOSITO DE TERCERO,,9280,,Deposito,
570,BBVA,28/02/2024,W02 DEPOSITO DE TERCERO,,12296,,Deposito,
571,BBVA,28/02/2024,N06 PAGO CUENTA DE TERCERO,,239800,,Retiro,
572,BBVA,29/02/2024,T09 TEF RECIBIDO BANORTE,,9570,,Deposito,
573,BBVA,29/02/2024,W02 DEPOSITO DE TERCERO,,9280,,Deposito,
574,BBVA,29/02/2024,N06 PAGO CUENTA DE TERCERO,,9817.05,,Retiro,
575,BBVA,29/02/2024,N03 TRASPASO CUENTAS PROPIAS,,760.7,,Retiro,
576,BBVA,29/02/2024,N03 TRASPASO CUENTAS PROPIAS,,234.06,,Retiro,
577,BBVA,29/02/2024,W02 DEPOSITO DE TERCERO,,22968,,Deposito,
578,BBVA,29/02/2024,W02 DEPOSITO DE TERCERO,,20880,,Deposito,
579,BBVA,29/02/2024,W02 DEPOSITO DE TERCERO,,20880,,Deposito,
580,BBVA,29/02/2024,W02 DEPOSITO DE TERCERO,,20880,,Deposito,
581,BBVA,29/02/2024,N06 PAGO CUENTA DE TERCERO,,20000,,Retiro,
582,BBVA,29/02/2024,N06 PAGO CUENTA DE TERCERO,,20000,,Deposito,
583,BBVA,29/02/2024,W02 DEPOSITO DE TERCERO,,20880,,Deposito,
584,BBVA,29/02/2024,T17 SPEI ENVIADO BANORTE,,38604.8,,Retiro,
585,BBVA,29/02/2024,T17 SPEI ENVIADO BANORTE,,18096,,Retiro,
586,BBVA,29/02/2024,N06 PAGO CUENTA DE TERCERO,,81200,,Retiro,
587,BBVA,29/02/2024,N06 PAGO CUENTA DE TERCERO,,3230.86,,Retiro,
588,BBVA,29/02/2024,U05 DEPOSITO DE FIDUCIARIO,,22968,,Deposito,
589,BBVA,29/02/2024,T20 SPEI RECIBIDOSTP,,29000,,Deposito,
590,BBVA,29/02/2024,T20 SPEI RECIBIDOBANORTE,,22968,,Deposito,
591,BBVA,29/02/2024,T20 SPEI RECIBIDOHSBC,,15660,,Deposito,
592,BBVA,29/02/2024,N06 PAGO CUENTA DE TERCERO,,53215,,Retiro,
593,BBVA,02/01/2024,T20 SPEI RECIBIDOBANORTE,,9914.66,,Deposito,
594,BBVA,03/01/2024,C07 DEP.CHEQUES DE OTRO BANCO,,145000,,Deposito,
595,BBVA,03/01/2024,N06 PAGO CUENTA DE TERCERO,,2900,,Deposito,
596,BBVA,04/01/2024,W02 DEPOSITO DE TERCERO,,162400,,Deposito,
597,BBVA,04/01/2024,N06 PAGO CUENTA DE TERCERO,,8407.09,,Retiro,
598,BBVA,04/01/2024,BT2 TRANSFER BBVA 00841021 L,,6960,,Deposito,
599,BBVA,05/01/2024,S39 SERV BANCA INTERNET,,250,,Retiro,
600,BBVA,05/01/2024,S39 SERV BANCA INTERNET,,215,,Retiro,
601,BBVA,05/01/2024,S40 IVA COM SERV BCA INTERNET,,74.4,,Retiro,
602,BBVA,05/01/2024,P14 AMERICAN EXPRESS,,35041.2,,Retiro,
603,BBVA,08/01/2024,T20 SPEI RECIBIDOBANORTE,,11600,,Deposito,
604,BBVA,08/01/2024,W02 DEPOSITO DE TERCERO,,67280,,Deposito,
605,BBVA,08/01/2024,N06 PAGO CUENTA DE TERCERO,,1554,,Retiro,
606,BBVA,08/01/2024,T17 SPEI ENVIADO BANORTE,,18096,,Retiro,
607,BBVA,08/01/2024,T17 SPEI ENVIADO BANORTE,,38604.8,,Retiro,
608,BBVA,09/01/2024,T17 SPEI ENVIADO SCOTIABANK,,6000,,Retiro,
609,BBVA,09/01/2024,T20 SPEI RECIBIDOSANTANDER,,14616,,Deposito,
610,BBVA,09/01/2024,T20 SPEI RECIBIDOBAJIO,,9280,,Deposito,
611,BBVA,09/01/2024,T20 SPEI RECIBIDOSCOTIABANK,,19720,,Deposito,
612,BBVA,10/01/2024,N06 PAGO CUENTA DE TERCERO,,1412,,Retiro,
613,BBVA,10/01/2024,N06 PAGO CUENTA DE TERCERO,,42533.3,,Deposito,
614,BBVA,10/01/2024,N06 PAGO CUENTA DE TERCERO,,146160,,Deposito,
615,BBVA,10/01/2024,W02 DEPOSITO DE TERCERO,,7670.5,,Deposito,
616,BBVA,11/01/2024,W02 DEPOSITO DE TERCERO,,10440,,Deposito,
617,BBVA,11/01/2024,N06 PAGO CUENTA DE TERCERO,,15971.4,,Retiro,
618,BBVA,11/01/2024,N03 TRASPASO CUENTAS PROPIAS,,57249.8,,Retiro,
619,BBVA,11/01/2024,N03 TRASPASO CUENTAS PROPIAS,,44542.5,,Retiro,
620,BBVA,11/01/2024,W02 DEPOSITO DE TERCERO,,22011,,Deposito,
621,BBVA,11/01/2024,W02 DEPOSITO DE TERCERO,,5359.2,,Deposito,
622,BBVA,11/01/2024,W02 DEPOSITO DE TERCERO,,43639.2,,Deposito,
623,BBVA,11/01/2024,W02 DEPOSITO DE TERCERO,,13015.2,,Deposito,
624,BBVA,11/01/2024,W02 DEPOSITO DE TERCERO,,34336,,Deposito,
625,BBVA,11/01/2024,N06 PAGO CUENTA DE TERCERO,,17400,,Deposito,
626,BBVA,11/01/2024,TK7 SITB2HONORARIOSAUDITORIAE,,45240,,Deposito,
627,BBVA,11/01/2024,TK7 SITB2F9849 MALDONADO,,45240,,Deposito,
628,BBVA,11/01/2024,W02 DEPOSITO DE TERCERO,,23200,,Deposito,
629,BBVA,12/01/2024,T20 SPEI RECIBIDOBANAMEX,,24128,,Deposito,
630,BBVA,12/01/2024,N06 PAGO CUENTA DE TERCERO,,285300,,Retiro,
631,BBVA,12/01/2024,T20 SPEI RECIBIDOSANTANDER,,8816,,Deposito,
632,BBVA,12/01/2024,W02 DEPOSITO DE TERCERO,,12325,,Deposito,
633,BBVA,12/01/2024,W02 DEPOSITO DE TERCERO,,25665,,Deposito,
634,BBVA,12/01/2024,N06 PAGO CUENTA DE TERCERO,,7814,,Retiro,
635,BBVA,12/01/2024,N06 PAGO CUENTA DE TERCERO,,184,,Retiro,
636,BBVA,15/01/2024,W02 DEPOSITO DE TERCERO,,9280,,Deposito,
637,BBVA,15/01/2024,N06 PAGO CUENTA DE TERCERO,,19720,,Deposito,
638,BBVA,15/01/2024,N03 TRASPASO CUENTAS PROPIAS,,9109.3,,Retiro,
639,BBVA,15/01/2024,N03 TRASPASO CUENTAS PROPIAS,,6485.52,,Retiro,
640,BBVA,15/01/2024,N06 PAGO CUENTA DE TERCERO,,8787,,Retiro,
641,BBVA,16/01/2024,N06 PAGO CUENTA DE TERCERO,,8120,,Deposito,
642,BBVA,16/01/2024,W02 DEPOSITO DE TERCERO,,32282.8,,Deposito,
643,BBVA,16/01/2024,W02 DEPOSITO DE TERCERO,,5359.2,,Deposito,
644,BBVA,16/01/2024,N06 PAGO CUENTA DE TERCERO,,599,,Retiro,
645,BBVA,16/01/2024,N03 TRASPASO CUENTAS PROPIAS,,73783.2,,Retiro,
646,BBVA,16/01/2024,N03 TRASPASO CUENTAS PROPIAS,,34197.8,,Retiro,
647,BBVA,17/01/2024,N06 PAGO CUENTA DE TERCERO,,5800,,Deposito,
648,BBVA,17/01/2024,T20 SPEI RECIBIDOSCOTIABANK,,2023.97,,Deposito,
649,BBVA,17/01/2024,T20 SPEI RECIBIDOSCOTIABANK,,9425,,Deposito,
650,BBVA,18/01/2024,T20 SPEI RECIBIDOBANREGIO,,9976,,Deposito,
651,BBVA,18/01/2024,W02 DEPOSITO DE TERCERO,,2679.6,,Deposito,
652,BBVA,18/01/2024,TJ3 SITB22591,,23490,,Deposito,
653,BBVA,18/01/2024,P14 TELCEL,,399,,Retiro,
654,BBVA,18/01/2024,P14 TELCEL,,648.99,,Retiro,
655,BBVA,18/01/2024,N06 PAGO CUENTA DE TERCERO,,10875.2,,Retiro,
656,BBVA,22/01/2024,W02 DEPOSITO DE TERCERO,,13398,,Deposito,
657,BBVA,22/01/2024,N06 PAGO CUENTA DE TERCERO,,1137.7,,Retiro,
658,BBVA,22/01/2024,N06 PAGO CUENTA DE TERCERO,,22504,,Deposito,
659,BBVA,22/01/2024,T20 SPEI RECIBIDOSANTANDER,,4640,,Deposito,
660,BBVA,22/01/2024,N03 TRASPASO CUENTAS PROPIAS,,5251.15,,Retiro,
661,BBVA,23/01/2024,T17 SPEI ENVIADO SANTANDER,,5688,,Retiro,
662,BBVA,23/01/2024,T17 SPEI ENVIADO SCOTIABANK,,26680,,Retiro,
663,BBVA,23/01/2024,N06 PAGO CUENTA DE TERCERO,,3480,,Deposito,
664,BBVA,23/01/2024,N06 PAGO CUENTA DE TERCERO,,3480,,Deposito,
665,BBVA,23/01/2024,T17 SPEI ENVIADO BANORTE,,2204,,Retiro,
666,BBVA,23/01/2024,N06 PAGO CUENTA DE TERCERO,,701.5,,Retiro,
667,BBVA,24/01/2024,N03 TRASPASO CUENTAS PROPIAS,,67923,,Retiro,
668,BBVA,24/01/2024,N03 TRASPASO CUENTAS PROPIAS,,62957,,Retiro,
669,BBVA,24/01/2024,N06 PAGO CUENTA DE TERCERO,,393.21,,Retiro,
670,BBVA,24/01/2024,N06 PAGO CUENTA DE TERCERO,,6090,,Deposito,
671,BBVA,24/01/2024,N06 PAGO CUENTA DE TERCERO,,23200,,Deposito,
672,BBVA,24/01/2024,T20 SPEI RECIBIDOBANORTE,,4060,,Deposito,
673,BBVA,25/01/2024,T17 SPEI ENVIADO BANORTE,,38604.8,,Retiro,
674,BBVA,25/01/2024,T17 SPEI ENVIADO BANORTE,,18096,,Retiro,
675,BBVA,25/01/2024,W02 DEPOSITO DE TERCERO,,2436,,Deposito,
676,BBVA,25/01/2024,W02 DEPOSITO DE TERCERO,,14024.4,,Deposito,
677,BBVA,25/01/2024,TK7 SITB2F1E0CD MALDONADO VIL,,46400,,Deposito,
678,BBVA,26/01/2024,N03 TRASPASO CUENTAS PROPIAS,,14616,,Retiro,
679,BBVA,26/01/2024,N03 TRASPASO CUENTAS PROPIAS,,51483.5,,Retiro,
680,BBVA,26/01/2024,N03 TRASPASO CUENTAS PROPIAS,,44542.5,,Retiro,
681,BBVA,26/01/2024,T20 SPEI RECIBIDOBANORTE,,13920,,Deposito,
682,BBVA,26/01/2024,T20 SPEI RECIBIDOHSBC,,3197.25,,Deposito,
683,BBVA,29/01/2024,T17 SPEI ENVIADO STP,,4047.94,,Retiro,
684,BBVA,29/01/2024,N03 TRASPASO CUENTAS PROPIAS,,9753.64,,Retiro,
685,BBVA,29/01/2024,N03 TRASPASO CUENTAS PROPIAS,,8373.09,,Retiro,
686,BBVA,29/01/2024,N06 PAGO CUENTA DE TERCERO,,1000,,Retiro,
687,BBVA,29/01/2024,W02 DEPOSITO DE TERCERO,,5104,,Deposito,
688,BBVA,29/01/2024,T20 SPEI RECIBIDOBANAMEX,,12180,,Deposito,
689,BBVA,29/01/2024,N06 PAGO CUENTA DE TERCERO,,3828,,Deposito,
690,BBVA,30/01/2024,W02 DEPOSITO DE TERCERO,,25520,,Deposito,
691,BBVA,30/01/2024,N06 PAGO CUENTA DE TERCERO,,10000,,Retiro,
692,BBVA,30/01/2024,N06 PAGO CUENTA DE TERCERO,,8787,,Retiro,
693,BBVA,30/01/2024,N06 PAGO CUENTA DE TERCERO,,20000,,Retiro,
694,BBVA,30/01/2024,N06 PAGO CUENTA DE TERCERO,,6380,,Deposito,
695,BBVA,31/01/2024,N06 PAGO CUENTA DE TERCERO,,162400,,Retiro,
696,BBVA,31/01/2024,N06 PAGO CUENTA DE TERCERO,,8932,,Deposito,
697,BBVA,31/01/2024,W02 DEPOSITO DE TERCERO,,15590.4,,Deposito,
698,BBVA,31/01/2024,W02 DEPOSITO DE TERCERO,,9280,,Deposito,
699,BBVA,31/01/2024,N06 PAGO CUENTA DE TERCERO,,119481,,Retiro,
700,BBVA,31/01/2024,T20 SPEI RECIBIDOHSBC,,15660,,Deposito,
701,BBVA,31/01/2024,T20 SPEI RECIBIDOBANORTE,,3480,,Deposito,
702,BBVA,31/01/2024,T20 SPEI RECIBIDOSANTANDER,,928,,Deposito,
703,BBVA,31/01/2024,N06 PAGO CUENTA DE TERCERO,,38666.7,,Deposito,
704,BBVA,31/01/2024,P14 AMERICAN EXPRESS,,37849.9,,Retiro,
705,Scotiabank,02/12/2024,Fecha Concepto Origen/Referencia DepÃ³sito Retiro Saldo TRANSF INTERBANCARIA SPEI,505,46400,231333,Deposito,
706,Scotiabank,02/12/2024,TRANSF INTERBANCARIA SPEI /PUNTA QUATRO PA HSBC495690 PUNTA QUATRO Q S A DE C V //021650040525691008 SEL TRANSF. INTERBANCARIA SPEI,21224,3250,228083,Retiro,
707,Scotiabank,02/12/2024,BBVA MEXICO PAGO /38933599 17:11:12 2024120240044B36K0000063380586 FECHA OPERACION: MALDONADO VILLASENOR CONSULTOR ES SC /012650001152113790 SEL TRASPASO ENTRE CUENTAS,18,950,227133,Retiro,
708,Scotiabank,02/12/2024,BERCANDA PAGO HOSPEDAJE 001738770027 17:15:28 TRANSF INTERBANCARIA SPEI,21224,1200,228333,Deposito,
709,Scotiabank,02/12/2024,TRANSF INTERBANCARIA SPEI /HONORARIOS CONT 7279CP01202412023589895246 FRANCISCA GUASCH CANELA //072650000152273082 03 DIC TRANSF INTERBANCARIA SPEI,2410240,1100,229433,Deposito,
710,Scotiabank,03/12/2024,TRANSF INTERBANCARIA SPEI /CONTABILIDAD DI MBAN01002412030079559705 OLIVIA LINARES ROMERO //012650011746360237 SEL TRANSF. INTERBANCARIA SPEI,31224,500,228933,Retiro,
711,Scotiabank,03/12/2024,STP RECARGA TAG /42701597 14:34:29 2024120340044B36K0000063401273 FECHA OPERACION: COBRO ELECTRONICO DE PEAJE SA DE CV /646180103301286283 SEL TRANSF. INTERBANCARIA SPEI,31224,103000,125933,Retiro,
712,Scotiabank,03/12/2024,BBVA MEXICO PAGO FINIQUITO /43189477 16:31:31 2024120340044B36K0000063406318 FECHA OPERACION: MALDONADO VILLASENOR CONSULTOR ES SC /012650001164911702 04 DIC TRANSF INTERBANCARIA SPEI,309240,2820.01,128753,Deposito,
713,Scotiabank,04/12/2024,TRANSF INTERBANCARIA SPEI /HONORARIOS NOV2 MBAN01002412040082256806 LUZ DEL CARMEN PELLICO GOMEZ H /ARO/012650001868877 SEL TRANSF. INTERBANCARIA SPEI,41224,6000,122753,Retiro,
714,Scotiabank,04/12/2024,SANTANDER COMPRA DE COMBUSTIBLE MALDONADO VILLASE /46300072 13:49:10 2024120440044B36K0000063426454 FECHA OPERACION: YZI AVENTURA LOMAS S DE RL DE CV /014180655041399947 SEL TRANSF. INTERBANCARIA SPEI,41224,12336.3,110417,Retiro,
715,Scotiabank,04/12/2024,"BBVA MEXICO GASTOS VARIOS VACU /46575850 13:57:46 2024120440044B36K0000063426895 FECHA OPERACION: ""Para los efectos del art. 100 de la Ley de Instituciones de CrÃ©dito, se hace constar que la presente impresiÃ³n proviene de medios magnÃ©ticos y digitales que obran en los archivos de esta InstituciÃ³n"" Scotiabank Inverlat S.A. 004094 PAGINA 3 DE 17 Cuenta 25601852364 Detalledetusmovimientos Fecha Concepto Origen/Referencia DepÃ³sito Retiro Saldo MALDONADO VILLASENOR CONSULTOR ES SC /012650001164911702 SEL TRANSF. INTERBANCARIA SPEI",41224,5500,104917,Retiro,
716,Scotiabank,04/12/2024,BBVA MEXICO GASTOS VARIOS LMCS /46579312 13:59:41 2024120440044B36K0000063426987 FECHA OPERACION: MALDONADO VILLASENOR CONSULTOR ES SC /012650001164911702 SEL TRANSF. INTERBANCARIA SPEI,41224,838,104079,Retiro,
717,Scotiabank,04/12/2024,BBVA MEXICO PAGO F. A57953 CUOTA MENSUAL /46610176 14:08:28 2024120440044B36K0000063427501 FECHA OPERACION: COLEGIO DE CONTADORES PUBLICOS DEL ESTAD/012650001420485820 TRANSF INTERBANCARIA SPEI,41224,18775,122854,Deposito,
718,Scotiabank,04/12/2024,TRANSF INTERBANCARIA SPEI /C3798 8846APR2202412043594798981 PROACTIVE SUPPLY CHAIN SOLUTIO /NS S DE RL/07265001 TRANSF INTERBANCARIA SPEI,3769,4300,127154,Deposito,
719,Scotiabank,04/12/2024,TRANSF INTERBANCARIA SPEI /PAGO DE HONORAR BNET01002412040030804652 EMILIO PELLICO GOMEZ HARO //012650001889051426 TRANSF INTERBANCARIA SPEI,41224,2120,129274,Deposito,
720,Scotiabank,04/12/2024,"TRANSF INTERBANCARIA SPEI /CONTABILIDAD 085905336104333946 AURORA,GARCIA TERUEL/Y MALDONA /DO/0026500817452863 05 DIC SEL TRANSF. INTERBANCARIA SPEI",51224,2858.95,126415,Retiro,
721,Scotiabank,05/12/2024,BBVA MEXICO PAGO TARJETA AMERICAN /48945056 09:49:19 2024120540044B36K0000063442327 FECHA OPERACION: MALDONADO VILLASENOR CONSULTOR ES SC /012650001164911702 SEL TRANSF. INTERBANCARIA SPEI,51224,2842,123573,Retiro,
722,Scotiabank,05/12/2024,SANTANDER PAGO F. B10929 LICENCIA DIC /48943388 09:52:46 2024120540044B36K0000063442452 FECHA OPERACION: SYSTEMS BCT MEXICO SAP DE CV /014150655067062835 TRANSF INTERBANCARIA SPEI,51224,6960,130533,Deposito,
723,Scotiabank,05/12/2024,TRANSF INTERBANCARIA SPEI /FACTURA C3779 7875APR2202412053597338993 HA CNC TECHNIK SA DE CV //072650012364849412 TRANSF INTERBANCARIA SPEI,51224,9575,140108,Deposito,
724,Scotiabank,05/12/2024,TRANSF INTERBANCARIA SPEI /FACTURA C 3753 BNET01002412050031032219 55 SOLUCION AC //012650001722144827 004094 PAGINA 4 DE 17 Cuenta 25601852364 Detalledetusmovimientos Fecha Concepto Origen/Referencia DepÃ³sito Retiro Saldo TRANSF INTERBANCARIA SPEI,3815,5220,145328,Deposito,
725,Scotiabank,05/12/2024,TRANSF INTERBANCARIA SPEI /C3815 036INBU05122024182769401 ADMINISTRACION CEORTE SC //036650500646647042 TRANSF INTERBANCARIA SPEI,3755,9860,155188,Deposito,
726,Scotiabank,05/12/2024,TRANSF INTERBANCARIA SPEI /C3755 036INBU05122024182769053 ADMINISTRACION CEORTE SC //036650500646647042 SEL TRASPASO ENTRE CUENTAS,18,10440,165628,Deposito,
727,Scotiabank,06/12/2024,MALDONADO VILLASE OR PAGO F. C3802 HONORARIOS DIC 001750350414 17:35:07 SEL TRASPASO ENTRE CUENTAS,18,6496,172124,Deposito,
728,Scotiabank,06/12/2024,MALDONADO VILLASE OR PAGO F. C3807 HONORARIOS NOV 001752373620 10:55:57 SEL TRASPASO ENTRE CUENTAS,18,687.91,172812,Deposito,
729,Scotiabank,06/12/2024,MALDONADO VILLASE OR PAGO F. C3811 HONOR SERV ARCHI 001752412480 11:07:34 SEL TRASPASO ENTRE CUENTAS,18,61700.4,234513,Deposito,
730,Scotiabank,06/12/2024,MALDONADO VILLASE OR PAGO F. C3806 HONORARIOS NOV 001752420446 11:10:07 SEL TRASPASO ENTRE CUENTAS,18,61700.4,296213,Deposito,
731,Scotiabank,06/12/2024,MALDONADO VILLASE OR PAGO F.C3805 HONORARIOS NOV 001752426599 11:15:18 TRANSF INTERBANCARIA SPEI,22,16653,312866,Deposito,
732,Scotiabank,06/12/2024,TRANSF INTERBANCARIA SPEI /PAGO 3774 DEL P HSBC577173 FUNDACION DEPORTIVO PARQUE ESP /ANA I/0216500402526 TRANSF INTERBANCARIA SPEI,61224,8045.01,320911,Deposito,
733,Scotiabank,06/12/2024,TRANSF INTERBANCARIA SPEI /3734 BNET01002412060031294694 GERSOR SA DE CV //012650001694112327 TRANSF INTERBANCARIA SPEI,61224,4235,325146,Deposito,
734,Scotiabank,06/12/2024,TRANSF INTERBANCARIA SPEI /3733 BNET01002412060031345161 CENTRO UNIVERSITARIO ALBADA //012650001641269045 TRANSF INTERBANCARIA SPEI,61224,6736,331882,Deposito,
735,Scotiabank,06/12/2024,TRANSF INTERBANCARIA SPEI /COPARMEX PUEBLA BNET01002412060000454082 CENTRO EMPRESARIAL D E PUEBLA /SP/0126500015028373 TRANSF INTERBANCARIA SPEI,2,2630,334512,Deposito,
736,Scotiabank,06/12/2024,TRANSF INTERBANCARIA SPEI /PAGO CONTABILID 2024120640014SNET0000470235870 LILIA ADRIANA GARCIA CORONADO //014650605667985147 TRANSF INTERBANCARIA SPEI,61224,9175,343687,Deposito,
737,Scotiabank,06/12/2024,"TRANSF INTERBANCARIA SPEI /3735 BNET01002412060031463246 ""Para los efectos del art. 100 de la Ley de Instituciones de CrÃ©dito, se hace constar que la presente impresiÃ³n proviene de medios magnÃ©ticos y digitales que obran en los archivos de esta InstituciÃ³n"" Scotiabank Inverlat S.A. 004094 PAGINA 5 DE 17 Cuenta 25601852364 Detalledetusmovimientos Fecha Concepto Origen/Referencia DepÃ³sito Retiro Saldo DISTRIBUCIONES BONAS ORT SA DE / CV/012650001609423 09 DIC TRANSF INTERBANCARIA SPEI",3756,7147,350834,Deposito,
738,Scotiabank,09/12/2024,TRANSF INTERBANCARIA SPEI /PAGO CFDI C3756 085900060130334248 AGROINSUMOS DISAGRO SA DE CV //002650081747922258 TRANSF INTERBANCARIA SPEI,71224,1610,352444,Deposito,
739,Scotiabank,09/12/2024,TRANSF INTERBANCARIA SPEI /PAGO FACT C3787 HSBC544985 MARIA ANGELICA DE LA HUERTA R /ESENDIZ/02165006542 SEL TRASPASO ENTRE CUENTAS,18,9280,361724,Deposito,
740,Scotiabank,09/12/2024,MALDONADO VILLASE OR PAGO F. C3809 HONORARIOS NOV 001757765559 09:59:38 TRANSF INTERBANCARIA SPEI,5251,20880,382604,Deposito,
741,Scotiabank,09/12/2024,TRANSF INTERBANCARIA SPEI /HONORARIOS CONT 002601002412090000686053 BANCO ACTINVER SA PO R CTA FID /EICOMISO F/01265000 03 POR COBRANZA DOMICILIADA,1759144723,15364,367240,Retiro,
742,Scotiabank,10/12/2024,RFC/CURP: TEL681113KD2 IVA: 0.00 FOLIO DE RASTREO: 00020241209003514 NUMERO REFERENCIA: 0241209 TRANSF INTERBANCARIA SPEI,101224,14520,381760,Deposito,
743,Scotiabank,10/12/2024,TRANSF INTERBANCARIA SPEI /CONTABILIDAD 3T BNET01002412100032020422 THREE TURTLE LIMITED SA DE CV //012650001162967266 11 DIC SEL TRANSF. INTERBANCARIA SPEI,111224,4291.6,377468,Retiro,
744,Scotiabank,11/12/2024,BBVA MEXICO PAGO 3% LMCS /63552089 11:42:02 2024121140044B36K0000063596889 FECHA OPERACION: MALDONADO VILLASENOR CONSULTOR ES SC /012650001164911702 SEL TRANSF. INTERBANCARIA SPEI,111224,38594.1,338874,Retiro,
745,Scotiabank,11/12/2024,BBVA MEXICO PAGO 3% NOV VACU /63598860 11:58:32 2024121140044B36K0000063597875 FECHA OPERACION: MALDONADO VILLASENOR CONSULTOR ES SC /012650001164911702 SEL TRANSF. INTERBANCARIA SPEI,111224,14167,324707,Retiro,
746,Scotiabank,11/12/2024,BBVA MEXICO PAGO GASTOS 45 ANIV VACU /63945652 13:39:55 2024121140044B36K0000063604790 FECHA OPERACION: MALDONADO VILLASENOR CONSULTOR ES SC /012650001164911702 SEL TRANSF. INTERBANCARIA SPEI,111224,2500,322207,Retiro,
747,Scotiabank,11/12/2024,BBVA MEXICO PAGO GASTOS 45 ANIV LMCS /63947817 13:41:35 004094 PAGINA 6 DE 17 Cuenta 25601852364 Detalledetusmovimientos Fecha Concepto Origen/Referencia DepÃ³sito Retiro Saldo 2024121140044B36K0000063604911 FECHA OPERACION: MALDONADO VILLASENOR CONSULTOR ES SC /012650001164911702 SEL TRASPASO ENTRE CUENTAS,18,29580,351787,Deposito,
748,Scotiabank,11/12/2024,MALDONADO VILLASENOR CONSULTOR PAGO F.C3808 HONORARIOS NOV 001764081906 14:17:51 SEL TRANSF. INTERBANCARIA SPEI,111224,270479,81308.2,Retiro,
749,Scotiabank,11/12/2024,"BBVA MEXICO PAGO NOM1A DIC, AG, PV /64062030 14:19:39 2024121140044B36K0000063607477 FECHA OPERACION: MALDONADO VILLASENOR CONSULTOR ES SC /012650001164911702 TRANSF INTERBANCARIA SPEI",1112240,14520,95828.2,Deposito,
750,Scotiabank,11/12/2024,TRANSF INTERBANCARIA SPEI /CONTABILIDAD BNET01002412110032499576 THREE TURTLE LIMITED SA DE CV //012650001162967266 TRANSF INTERBANCARIA SPEI,1112240,1750,97578.2,Deposito,
751,Scotiabank,11/12/2024,TRANSF INTERBANCARIA SPEI /CONTA BNET01002412110032500064 THREE TURTLE LIMITED SA DE CV //012650001162967266 TRANSF INTERBANCARIA SPEI,1112240,1750,99328.2,Deposito,
752,Scotiabank,11/12/2024,TRANSF INTERBANCARIA SPEI /CONTA BNET01002412110032500648 THREE TURTLE LIMITED SA DE CV //012650001162967266 TRANSF INTERBANCARIA SPEI,111224,5060,104388,Deposito,
753,Scotiabank,11/12/2024,TRANSF INTERBANCARIA SPEI /C3765 BNET01002412110032517210 CARLOS RUIZ ACEVEDO //012650001915306155 13 DIC SEL TRASPASO ENTRE CUENTAS,18,20300,124688,Deposito,
754,Scotiabank,13/12/2024,MALDONADO VILLASE OR PAGO F. C3804 HONORARIOS NOV 001766449538 11:54:55 SEL TRANSF. INTERBANCARIA SPEI,121224,15438.6,109250,Retiro,
755,Scotiabank,13/12/2024,BBVA MEXICO PAGO F. A1158 APOYO CALCULO IMPTOS /67544514 06:24:03 2024121240044B36K0000063627883 FECHA OPERACION: SINERGIA CORPORATIVA VILLESANT SA DE CV /012650001111240565 TRANSF INTERBANCARIA SPEI,5251,12412,121662,Deposito,
756,Scotiabank,13/12/2024,TRANSF INTERBANCARIA SPEI /CONSULTORIA MEN 002601002412130000614231 BANCO ACTINVER SA PO R CTA FID /EICOMISO F/01265000 TRANSF INTERBANCARIA SPEI,50,16653,138315,Deposito,
757,Scotiabank,13/12/2024,"TRANSF INTERBANCARIA SPEI /PAGO 3816 DEL P HSB5208252 FUNDACION DEPORTIVO PARQUE ESP ""Para los efectos del art. 100 de la Ley de Instituciones de CrÃ©dito, se hace constar que la presente impresiÃ³n proviene de medios magnÃ©ticos y digitales que obran en los archivos de esta InstituciÃ³n"" Scotiabank Inverlat S.A. 004094 PAGINA 7 DE 17 Cuenta 25601852364 Detalledetusmovimientos Fecha Concepto Origen/Referencia DepÃ³sito Retiro Saldo /ANA I/0216500402526 TRANSF INTERBANCARIA SPEI",507,17400,155715,Deposito,
758,Scotiabank,13/12/2024,"TRANSF INTERBANCARIA SPEI /ANDREAS STIHL S 002601002412130000732420 ANDREAS STIHL,SA DE CV //012650004476808131 TRANSF INTERBANCARIA SPEI",131224,4235,159950,Deposito,
759,Scotiabank,13/12/2024,TRANSF INTERBANCARIA SPEI /3799 BNET01002412130032921652 CENTRO UNIVERSITARIO ALBADA //012650001641269045 TRANSF INTERBANCARIA SPEI,14626,92800,252750,Deposito,
760,Scotiabank,13/12/2024,TRANSF INTERBANCARIA SPEI /PAGO37062 002601002412130000830401 PRODUCTOS AVICOLAS E L CALVARI /O S DE RL/012650001 TRANSF INTERBANCARIA SPEI,7709028,8000,260750,Deposito,
761,Scotiabank,13/12/2024,TRANSF INTERBANCARIA SPEI /PAGO NOV DIC 2024121340014SNET0000453465210 JOSE MANUEL CERVANTES JIMENEZ //014650606195121223 TRANSF INTERBANCARIA SPEI,528107,21112,281862,Deposito,
762,Scotiabank,13/12/2024,TRANSF INTERBANCARIA SPEI /PAGO A PROVEEDO CIE-0100241213038100 SERVICIOS INMOBILIAR IOS AUGE /HOGAR SA D/01265000 16 DIC TRANSF INTERBANCARIA SPEI,812240,5860,287722,Deposito,
763,Scotiabank,16/12/2024,TRANSF INTERBANCARIA SPEI /SERVCIIOS CONTA MBAN01002412160085768086 MARCELO RODRIGUEZ GUZMAN //012650004691146966 SEL TRANSF. INTERBANCARIA SPEI,161224,4344.44,283377,Retiro,
764,Scotiabank,16/12/2024,BBVA MEXICO PAGO NOTARIO DFK /75187975 09:45:17 2024121640044B36K0000063729606 FECHA OPERACION: MALDONADO VILLASENOR CONSULTOR ES SC /012650001152113790 SEL TRANSF. INTERBANCARIA SPEI,161224,7806.25,275571,Retiro,
765,Scotiabank,16/12/2024,BBVA MEXICO PAGO SERVICIOS DE CONTABILIDAD /75210569 09:48:56 2024121640044B36K0000063729744 FECHA OPERACION: FERNANDA ESPINOSA VILLASENOR /012650015490876387 SEL TRANSF. INTERBANCARIA SPEI,161224,20000,255571,Retiro,
766,Scotiabank,16/12/2024,BBVA MEXICO PAGO HONORARIOS PUNTA QUATRO /75364543 10:55:15 2024121640044B36K0000063733218 FECHA OPERACION: MALDONADO VILLASENOR CONSULTOR ES SC /012650001152113790 TRANSF INTERBANCARIA SPEI,161224,3500,259071,Deposito,
767,Scotiabank,16/12/2024,TRANSF INTERBANCARIA SPEI /FACT. C 3782 004094 PAGINA 8 DE 17 Cuenta 25601852364 Detalledetusmovimientos Fecha Concepto Origen/Referencia DepÃ³sito Retiro Saldo BNET01002412160033677429 JOSE RAFAEL CABA%AS ABREGO //012650001817231700 TRANSF INTERBANCARIA SPEI,1612248,12992,272063,Deposito,
768,Scotiabank,16/12/2024,TRANSF INTERBANCARIA SPEI /PROMOTORA OPCIO 002601002412170000518717 PROMOTORA OPCION SA DE CV //012650001936298213 17 DIC SEL TRANSF. INTERBANCARIA SPEI,171224,5800,266263,Retiro,
769,Scotiabank,17/12/2024,BBVA MEXICO PAGO F. 10388 REPORTES FINANCIEROS /79038299 10:42:58 2024121740044B36K0000063770239 FECHA OPERACION: MALDONADO VILLASENOR CONSULTOR ES SC /012650001164911702 TRANSF INTERBANCARIA SPEI,171224,7980,274243,Deposito,
770,Scotiabank,17/12/2024,TRANSF INTERBANCARIA SPEI /FACTURA CANACO BNET01002412170000586694 CAMARA DE COMERCIO S ERVICIOS /Y TURISMO/012650001 TRANSF INTERBANCARIA SPEI,171224,5220,279463,Deposito,
771,Scotiabank,17/12/2024,TRANSF INTERBANCARIA SPEI /FACTURA C3767 058-17/12/2024/17-270MNNL515 CYNTHIA CONCEPCION ORTEGA CERE /CEDO/05865000015175 DEPOSITOS SBC,CAMARA,2265,281728,Deposito,
772,Scotiabank,17/12/2024,PRESENTADA NO.649 0000000000000000018 DEPOSITOS SBC,CAMARA,10980,292708,Deposito,
773,Scotiabank,17/12/2024,PRESENTADA NO.2525 0000000000000000018 DEPOSITOS SBC,CAMARA,11782,304490,Deposito,
774,Scotiabank,17/12/2024,PRESENTADA NO.2170 0000000000000000018 DEPOSITOS SBC,CAMARA,2265,306755,Deposito,
775,Scotiabank,17/12/2024,PRESENTADA NO.890 0000000000000000018 DEPOSITOS SBC,CAMARA,12542,319297,Deposito,
776,Scotiabank,17/12/2024,PRESENTADA NO.1736 0000000000000000018 SEL TRANSF. INTERBANCARIA SPEI,171224,11600,307697,Retiro,
777,Scotiabank,17/12/2024,BBVA MEXICO PAGO F.10388 REPORTES VACU /79573741 12:14:32 2024121740044B36K0000063776596 FECHA OPERACION: MALDONADO VILLASENOR CONSULTOR ES SC /012650001164911702 TRANSF INTERBANCARIA SPEI,3791,6381,314078,Deposito,
778,Scotiabank,17/12/2024,TRANSF INTERBANCARIA SPEI /PAGO FACTURA BNET01002412170033911280 SERVICIOS ADMINISTRA TIVOS EMP /RESARIALES/01265000 TRANSF INTERBANCARIA SPEI,1712240,13110,327188,Deposito,
779,Scotiabank,17/12/2024,TRANSF INTERBANCARIA SPEI /SERVICIOS CONTA BNET01002412170033923380 VIVENTEM SA DE CV //012813001184675441 TRANSF INTERBANCARIA SPEI,804621,92800,419988,Deposito,
780,Scotiabank,17/12/2024,"TRANSF INTERBANCARIA SPEI /HOTELES SOLARIS 193D678C311DC30F ""Para los efectos del art. 100 de la Ley de Instituciones de CrÃ©dito, se hace constar que la presente impresiÃ³n proviene de medios magnÃ©ticos y digitales que obran en los archivos de esta InstituciÃ³n"" Scotiabank Inverlat S.A. 004094 PAGINA 9 DE 17 Cuenta 25601852364 Detalledetusmovimientos Fecha Concepto Origen/Referencia DepÃ³sito Retiro Saldo HOTELES SOLARIS DE MEXICO SA D /E CV/00267070167157 18 DIC TRANSF INTERBANCARIA SPEI",181224,20880,440868,Deposito,
781,Scotiabank,18/12/2024,TRANSF INTERBANCARIA SPEI /HONORARIOS CONT BNET01002412180034151842 SOLUCION INTEGRAL LO GISTICA D /E ALIMENTO/01265000 SEL TRASPASO ENTRE CUENTAS,18,9280,450148,Deposito,
782,Scotiabank,18/12/2024,MALDONADO VILLASE OR PAGO F.C3810 HONORARIOS NOVIEM 001784254181 12:16:31 SEL TRANSF. INTERBANCARIA SPEI,181224,5047.01,445101,Retiro,
783,Scotiabank,18/12/2024,BBVA MEXICO PAGO INTERDESK /84247467 12:17:42 2024121840044B36K0000063812054 FECHA OPERACION: MALDONADO VILLASENOR CONSULTOR ES SC /012650001164911702 SEL TRANSF. INTERBANCARIA SPEI,181224,786.72,444314,Retiro,
784,Scotiabank,18/12/2024,BBVA MEXICO PAGO LUZ VACU /84244380 12:21:42 2024121840044B36K0000063812330 FECHA OPERACION: MALDONADO VILLASENOR CONSULTOR ES SC /012650001164911702 SEL TRANSF. INTERBANCARIA SPEI,181224,8051.28,436263,Retiro,
785,Scotiabank,18/12/2024,BANAMEX PAGO PRESTAMO /82776707 12:31:03 2024121840044B36K0000063813006 FECHA OPERACION: VICTOR ANDR CACHON URIBE /002180700843511039 TRANSF INTERBANCARIA SPEI,181224,185600,621863,Deposito,
786,Scotiabank,18/12/2024,TRANSF INTERBANCARIA SPEI /PROD AGROPECUAR BNET01002412180000883676 MALDONADO VILLASE%OR CONSULTO /RES SC/012650001228 TRANSF INTERBANCARIA SPEI,181224,9880,631743,Deposito,
787,Scotiabank,18/12/2024,"TRANSF INTERBANCARIA SPEI /M VILLASE%OR FA BNET01002412180034261912 STERN MOTOS, S.A. DE C.V //012650001469905840 TRANSF INTERBANCARIA SPEI",6636248,22620,654363,Deposito,
788,Scotiabank,18/12/2024,TRANSF INTERBANCARIA SPEI /PAGO NICROBOLTA 20241218400140BET0000466362480 NICRO BOLTA SA DE CV //014650655068982304 19 DIC TRANSF INTERBANCARIA SPEI,191224,4640,659003,Deposito,
789,Scotiabank,19/12/2024,TRANSF INTERBANCARIA SPEI /FACTURA C3487 BNET01002412190000092165 FINANCIERA TORO SA D E CV //012650001913589602 TRANSF INTERBANCARIA SPEI,241219,7800,666803,Deposito,
790,Scotiabank,19/12/2024,TRANSF INTERBANCARIA SPEI /TRANSFERENCIA D 058-19/12/2024/19-270MOXH850 004094 PAGINA 10 DE 17 Cuenta 25601852364 Detalledetusmovimientos Fecha Concepto Origen/Referencia DepÃ³sito Retiro Saldo JESUS EMANUEL ORTEGA CERECEDO //058650000008473811 SEL TRANSF. INTERBANCARIA SPEI,191224,135314,531489,Retiro,
791,Scotiabank,19/12/2024,BBVA MEXICO PAGO IMPUESTOS NOV VACU /88972002 14:44:02 2024121940044B36K0000063859651 FECHA OPERACION: MALDONADO VILLASENOR CONSULTOR ES SC /012650001164911702 SEL TRANSF. INTERBANCARIA SPEI,191224,56020,475469,Retiro,
792,Scotiabank,19/12/2024,BBVA MEXICO PAGO IMPUESYOS NOV LMCS /88975429 14:45:25 2024121940044B36K0000063859762 FECHA OPERACION: MALDONADO VILLASENOR CONSULTOR ES SC /012650001164911702 SEL TRANSF. INTERBANCARIA SPEI,191224,31225,444244,Retiro,
793,Scotiabank,19/12/2024,BBVA MEXICO PAGO SERVICIOS CONTABILIDAD DIC-ENE /88969683 14:49:00 2024121940044B36K0000063860012 FECHA OPERACION: FERNANDA ESPINOSA VILLASENOR /012650015490876387 20 DIC SEL TRANSF. INTERBANCARIA SPEI,201224,43159,401085,Retiro,
794,Scotiabank,20/12/2024,BANAMEX PAGO REMANENTE /92401412 10:29:52 2024122040044B36K0000063881841 FECHA OPERACION: VICTOR ANDR CACHON URIBE /002180700843511039 SEL TRANSF. INTERBANCARIA SPEI,201224,17090,383995,Retiro,
795,Scotiabank,20/12/2024,BBVA MEXICO PAGO REMANENTE /92389198 10:31:31 2024122040044B36K0000063881943 FECHA OPERACION: VICTOR ANDR CACHON URIBE /012650001541565360 TRANSF INTERBANCARIA SPEI,201224,8045.01,392040,Deposito,
796,Scotiabank,20/12/2024,TRANSF INTERBANCARIA SPEI /3800 BNET01002412200034914970 GERSOR SA DE CV //012650001694112327 TRANSF INTERBANCARIA SPEI,241220,3800,395840,Deposito,
797,Scotiabank,20/12/2024,TRANSF INTERBANCARIA SPEI /TRANSFERENCIA D 058-20/12/2024/20-270MPRV473 JESUS EMANUEL ORTEGA CERECEDO //058650000008473811 TRANSF INTERBANCARIA SPEI,201224,9175,405015,Deposito,
798,Scotiabank,20/12/2024,TRANSF INTERBANCARIA SPEI /3801 BNET01002412200035030174 DISTRIBUCIONES BONAS ORT SA DE / CV/012650001609423 TRANSF INTERBANCARIA SPEI,201224,3251,408266,Deposito,
799,Scotiabank,20/12/2024,"TRANSF INTERBANCARIA SPEI /FACTURA C3009 BNET01002412200000799795 MAGNA RESIDENCIAL SA DE CV //012650001549291283 ""Para los efectos del art. 100 de la Ley de Instituciones de CrÃ©dito, se hace constar que la presente impresiÃ³n proviene de medios magnÃ©ticos y digitales que obran en los archivos de esta InstituciÃ³n"" Scotiabank Inverlat S.A. 004094 PAGINA 11 DE 17 Cuenta 25601852364 Detalledetusmovimientos Fecha Concepto Origen/Referencia DepÃ³sito Retiro Saldo 23 DIC SEL TRANSF. INTERBANCARIA SPEI",231224,22000,386266,Retiro,
800,Scotiabank,23/12/2024,BBVA MEXICO PAGO F.3490 GESTION TRAMITES GOBIERNO /98391117 11:47:21 2024122340044B36K0000063946443 FECHA OPERACION: CACHON VILLASENOR CONSULTORES SC /012650001866361605 TRANSF INTERBANCARIA SPEI,6229579,1610,387876,Deposito,
801,Scotiabank,23/12/2024,TRANSF INTERBANCARIA SPEI /HONORARIOS CONT 2024122340014BMOV0000454499580 MARIA DEL CARMEN LETICIA MEDIN /A PAREDES/014650605 TRANSF INTERBANCARIA SPEI,814,6960,394836,Deposito,
802,Scotiabank,23/12/2024,TRANSF INTERBANCARIA SPEI /FACT C814 MALDO 002601002412230000105848 HEINSS HARDY S SA DE CV //012830001179633196 TRANSF INTERBANCARIA SPEI,241223,5130,399966,Deposito,
803,Scotiabank,23/12/2024,TRANSF INTERBANCARIA SPEI /CP CACHON 3843CP05202412233654972240 JUAN CARLOS SALAZAR CAJICA //072650011860347590 24 DIC SEL TRANSF. INTERBANCARIA SPEI,241224,101106,298860,Retiro,
804,Scotiabank,24/12/2024,BBVA MEXICO PAGO NOMINA 2A QUIN DICIEMBRE /00867350 09:51:12 2024122440044B36K0000063974168 FECHA OPERACION: MALDONADO VILLASENOR CONSULTOR ES SC /012650001164911702 SEL TRANSF. INTERBANCARIA SPEI,241224,1000,297860,Retiro,
805,Scotiabank,24/12/2024,STP RECARGA TAG /00902958 10:00:30 2024122440044B36K0000063974499 FECHA OPERACION: COBRO ELECTRONICO DE PEAJE SA DE CV /646180103301286283 TRANSF INTERBANCARIA SPEI,241224,51620,349480,Deposito,
806,Scotiabank,24/12/2024,TRANSF INTERBANCARIA SPEI /FACTURA D517 BNET01002412240000164908 PSI CONSULTORIA PROF ESIONAL S /C/01268000154564030 TRANSF INTERBANCARIA SPEI,7794352,3015,352495,Deposito,
807,Scotiabank,24/12/2024,TRANSF INTERBANCARIA SPEI /HONOR PROF POR 20241224400140BET0000477943520 ACTUM ADMINISTRACION CONSULTOR /IA Y SERVI/01465092 TRANSF INTERBANCARIA SPEI,231224,42456,394951,Deposito,
808,Scotiabank,24/12/2024,TRANSF INTERBANCARIA SPEI /PAGO CEBI 8846APR2202412243656353728 CEBI INDUSTRIAS MEXICO SA DE C /V/07265000221421075 26 DIC TRANSF INTERBANCARIA SPEI,2612248,9048,403999,Deposito,
809,Scotiabank,26/12/2024,TRANSF INTERBANCARIA SPEI /HONORARIOS FIGO 002601002412260000294648 004094 PAGINA 12 DE 17 Cuenta 25601852364 Detalledetusmovimientos Fecha Concepto Origen/Referencia DepÃ³sito Retiro Saldo FIGONFER SC //012650001561434743 TRANSF INTERBANCARIA SPEI,261224,7050,411049,Deposito,
810,Scotiabank,26/12/2024,"TRANSF INTERBANCARIA SPEI /F3758 BNET01002412260036054917 ANDRESONS, S.A. DE C .V. //012650001886640131 TRANSF INTERBANCARIA SPEI",261224,5640,416689,Deposito,
811,Scotiabank,26/12/2024,"TRANSF INTERBANCARIA SPEI /F3759 BNET01002412260036060029 ANDRESONS, S.A. DE C .V. //012650001886640131 27 DIC TRANSF INTERBANCARIA SPEI",271224,6370,423059,Deposito,
812,Scotiabank,27/12/2024,TRANSF INTERBANCARIA SPEI /F 3777 HON NOV 085901475304336245 HYPERINFO SA DE CV //002650430300112454 30 DIC TRANSF INTERBANCARIA SPEI,281224,6990,430049,Deposito,
813,Scotiabank,30/12/2024,TRANSF INTERBANCARIA SPEI /F 3778 HON NOV 085900749704336345 HYPERMAIL SA DE CV //002650486500484266 SEL TRANSF. INTERBANCARIA SPEI,301224,2162.63,427886,Retiro,
814,Scotiabank,30/12/2024,BBVA MEXICO PAGO CANDADO MICROSIP /11199003 09:37:40 2024123040044B36K0000064078650 FECHA OPERACION: MALDONADO VILLASENOR CONSULTOR ES SC /012650001152113790 SEL TRANSF. INTERBANCARIA SPEI,301224,25520,402366,Retiro,
815,Scotiabank,30/12/2024,"BBVA MEXICO PAGO F. MCC7633 ASESORIA FISCAL CEBI /11211888 09:43:05 2024123040044B36K0000064078930 FECHA OPERACION: MALDONADO CONSULTING CPA, S.C. /012650001022437250 DEPOSITOS SBC",CAMARA,15432,417798,Deposito,
816,Scotiabank,30/12/2024,PRESENTADA NO.7617540 0000000000000000018 DEPOSITOS SBC,CAMARA,7716,425514,Deposito,
817,Scotiabank,30/12/2024,PRESENTADA NO.7617539 0000000000000000018 TRANSF INTERBANCARIA SPEI,3757,1100,426614,Deposito,
818,Scotiabank,30/12/2024,TRANSF INTERBANCARIA SPEI /ANA M GAM HSB5369985 ANA MARGARITA GONZALEZ ARAGON / MARTINEZ/021650040 TRANSF INTERBANCARIA SPEI,3792,8700,435314,Deposito,
819,Scotiabank,30/12/2024,TRANSF INTERBANCARIA SPEI /SISTEMAS ALTERN HSB5409674 SISTEMAS ALTERNATIVOS DE CARGA / Y GE/0216500404195 TRANSF INTERBANCARIA SPEI,395419,18000,453314,Deposito,
820,Scotiabank,30/12/2024,"TRANSF INTERBANCARIA SPEI /TRASPASO ENTRE 058-30/12/2024/30-270MULY791 MALDONADO VILLASE OR CONSULTOR ""Para los efectos del art. 100 de la Ley de Instituciones de CrÃ©dito, se hace constar que la presente impresiÃ³n proviene de medios magnÃ©ticos y digitales que obran en los archivos de esta InstituciÃ³n"" Scotiabank Inverlat S.A. 004094 PAGINA 13 DE 17 Cuenta 25601852364 Detalledetusmovimientos Fecha Concepto Origen/Referencia DepÃ³sito Retiro Saldo /ES S.C./05865000015 SEL TRANSF. INTERBANCARIA SPEI",301224,100000,353314,Retiro,
821,Scotiabank,30/12/2024,BBVA MEXICO PAGO F.3491 CAPTURA DATOS /12147926 15:03:50 2024123040044B36K0000064106909 FECHA OPERACION: CACHON VILLASENOR CONSULTORES SC /012650001866361605 31 DIC SEL TRANSF. INTERBANCARIA SPEI,311224,50333,302981,Retiro,
822,Scotiabank,31/12/2024,BBVA MEXICO PAGO REMANENTE /14406425 10:28:37 2024123140044B36K0000064133669 FECHA OPERACION: ALEJANDRA LOZANO POSADA /012650004443393048 SEL TRANSF. INTERBANCARIA SPEI,311224,227271,75710.5,Retiro,
823,Scotiabank,31/12/2024,BBVA MEXICO PAGO REMANENTE /14404969 10:31:41 2024123140044B36K0000064133846 FECHA OPERACION: LUIS MIGUEL CARVAJAL SANCHEZ /012650011100785063 SEL TRANSF. INTERBANCARIA SPEI,311224,3000,72710.5,Retiro,
824,Scotiabank,31/12/2024,BANORTE COMPRA COMBUSTIBLE /14426537 10:33:29 2024123140044B36K0000064133976 FECHA OPERACION: OPERADORA SAN MARTINITO SA DE CV /072650004066859912 SWEB TRASPASO ENTRE CUENTAS,18,3550.01,76260.6,Deposito,
825,Scotiabank,31/12/2024,TRANSFERENCIA A MALDONADO VILL COBRO DE COMISION,0,620,75640.6,Retiro,
826,Scotiabank,31/12/2024,SCOTIA EN LINEA MENSUALIDAD PYME NUM OP 000000001 0000000000000000502364130 311224 FORMA DE PAGO 03 IVA POR COMISIONES,16.00%,99.2,75541.4,Retiro,
827,BBVA,02/12/2024,T20 SPEI RECIBIDOBANORTE,,109434,,Deposito,
828,BBVA,02/12/2024,T20 SPEI RECIBIDOHSBC,,12000,,Deposito,
829,BBVA,02/12/2024,T17 SPEI ENVIADO BANORTE,,62540,,Retiro,
830,BBVA,02/12/2024,T20 SPEI RECIBIDOSANTANDER,,29000,,Deposito,
831,BBVA,02/12/2024,N03 TRASPASO CUENTAS PROPIAS,,31889,,Retiro,
832,BBVA,02/12/2024,N03 TRASPASO CUENTAS PROPIAS,,3723,,Retiro,
833,BBVA,02/12/2024,T20 SPEI RECIBIDOBAJIO,,22294.3,,Deposito,
834,BBVA,02/12/2024,N06 PAGO CUENTA DE TERCERO,,30972,,Retiro,
835,BBVA,02/12/2024,T20 SPEI RECIBIDOBANAMEX,,37555,,Deposito,
836,BBVA,02/12/2024,W02 DEPOSITO DE TERCERO,,5800,,Deposito,
837,BBVA,03/12/2024,T09 TEF RECIBIDO BANORTE,,8700,,Deposito,
838,BBVA,03/12/2024,N06 PAGO CUENTA DE TERCERO,,26100,,Deposito,
839,BBVA,03/12/2024,N06 PAGO CUENTA DE TERCERO,,22004,,Retiro,
840,BBVA,03/12/2024,N06 PAGO CUENTA DE TERCERO,,16158.8,,Deposito,
841,BBVA,03/12/2024,N06 PAGO CUENTA DE TERCERO,,9378.6,,Deposito,
842,BBVA,03/12/2024,T20 SPEI RECIBIDOBAJIO,,50112,,Deposito,
843,BBVA,03/12/2024,T20 SPEI RECIBIDOBAJIO,,50112,,Deposito,
844,BBVA,04/12/2024,W02 DEPOSITO DE TERCERO,,42920,,Deposito,
845,BBVA,04/12/2024,T20 SPEI RECIBIDOSANTANDER,,30148.4,,Deposito,
846,BBVA,04/12/2024,W02 DEPOSITO DE TERCERO,,12984.3,,Deposito,
847,BBVA,04/12/2024,T20 SPEI RECIBIDOHSBC,,11182.4,,Deposito,
848,BBVA,04/12/2024,T20 SPEI RECIBIDOHSBC,,11182.4,,Deposito,
849,BBVA,04/12/2024,N06 PAGO CUENTA DE TERCERO,,7888,,Deposito,
850,BBVA,04/12/2024,TK7 SITB2CONSULTORIAFACT6614F,,17724.8,,Deposito,
851,BBVA,05/12/2024,T20 SPEI RECIBIDOSANTANDER,,23200,,Deposito,
852,BBVA,05/12/2024,TK7 SITB2MA 5969 2,,11310,,Deposito,
853,BBVA,05/12/2024,N06 PAGO CUENTA DE TERCERO,,4088,,Retiro,
854,BBVA,05/12/2024,T20 SPEI RECIBIDOHSBC,,4524,,Deposito,
855,BBVA,05/12/2024,T20 SPEI RECIBIDOSANTANDER,,8584,,Deposito,
856,BBVA,05/12/2024,T20 SPEI RECIBIDOSANTANDER,,8584,,Deposito,
857,BBVA,05/12/2024,W02 DEPOSITO DE TERCERO,,44999.7,,Deposito,
858,BBVA,05/12/2024,T20 SPEI RECIBIDOBANORTE,,6519.2,,Deposito,
859,BBVA,05/12/2024,N06 PAGO CUENTA DE TERCERO,,15660,,Deposito,
860,BBVA,06/12/2024,T20 SPEI RECIBIDOCBM BANCO,,172538,,Deposito,
861,BBVA,06/12/2024,P14 OPENPAY SA PI DE CV,,2295,,Retiro,
862,BBVA,06/12/2024,P14 OPENPAY SA PI DE CV,,1449,,Retiro,
863,BBVA,06/12/2024,N06 PAGO CUENTA DE TERCERO,,26357.5,,Deposito,
864,BBVA,06/12/2024,N06 PAGO CUENTA DE TERCERO,,12200,,Retiro,
865,BBVA,06/12/2024,T20 SPEI RECIBIDOBANAMEX,,104816,,Deposito,
866,BBVA,06/12/2024,W02 DEPOSITO DE TERCERO,,5800,,Deposito,
867,BBVA,06/12/2024,T17 SPEI ENVIADO BANORTE,,30148.4,,Retiro,
868,BBVA,06/12/2024,W02 DEPOSITO DE TERCERO,,35496,,Deposito,
869,BBVA,06/12/2024,W02 DEPOSITO DE TERCERO,,11391.2,,Deposito,
870,BBVA,06/12/2024,T20 SPEI RECIBIDOBAJIO,,56711.2,,Deposito,
871,BBVA,06/12/2024,T20 SPEI RECIBIDOBAJIO,,2395.4,,Deposito,
872,BBVA,06/12/2024,T20 SPEI RECIBIDOSANTANDER,,29580,,Deposito,
873,BBVA,06/12/2024,T20 SPEI RECIBIDOBANAMEX,,9048,,Deposito,
874,BBVA,06/12/2024,T20 SPEI RECIBIDOBANAMEX,,11066.4,,Deposito,
875,BBVA,06/12/2024,T20 SPEI RECIBIDOBAJIO,,3132,,Deposito,
876,BBVA,06/12/2024,P31 TELERENTA SA DE CV 06129,,3120.11,,Retiro,
877,BBVA,09/12/2024,N06 PAGO CUENTA DE TERCERO,,21576,,Deposito,
878,BBVA,09/12/2024,N06 PAGO CUENTA DE TERCERO,,7888,,Deposito,
879,BBVA,09/12/2024,N06 PAGO CUENTA DE TERCERO,,3335,,Deposito,
880,BBVA,09/12/2024,T20 SPEI RECIBIDOBANAMEX,,50245.5,,Deposito,
881,BBVA,09/12/2024,N06 PAGO CUENTA DE TERCERO,,6050.56,,Deposito,
882,BBVA,09/12/2024,N06 PAGO CUENTA DE TERCERO,,10567.6,,Deposito,
883,BBVA,09/12/2024,N06 PAGO CUENTA DE TERCERO,,8282.4,,Deposito,
884,BBVA,10/12/2024,T17 SPEI ENVIADO BAJIO,,55100,,Retiro,
885,BBVA,10/12/2024,T20 SPEI RECIBIDOSANTANDER,,94733.7,,Deposito,
886,BBVA,10/12/2024,T20 SPEI RECIBIDOSANTANDER,,14616,,Deposito,
887,BBVA,10/12/2024,N06 PAGO CUENTA DE TERCERO,,5800,,Deposito,
888,BBVA,10/12/2024,N06 PAGO CUENTA DE TERCERO,,8120,,Deposito,
889,BBVA,10/12/2024,N06 PAGO CUENTA DE TERCERO,,4060,,Deposito,
890,BBVA,10/12/2024,N06 PAGO CUENTA DE TERCERO,,6186.66,,Deposito,
891,BBVA,10/12/2024,N06 PAGO CUENTA DE TERCERO,,4408,,Deposito,
892,BBVA,10/12/2024,T20 SPEI RECIBIDOSANTANDER,,27975,,Deposito,
893,BBVA,10/12/2024,W02 DEPOSITO DE TERCERO,,22965.3,,Deposito,
894,BBVA,10/12/2024,N06 PAGO CUENTA DE TERCERO,,7888,,Deposito,
895,BBVA,11/12/2024,E17 ORDEN DE PAGO EXTRANJERO,,112981,,Deposito,
896,BBVA,11/12/2024,E18 COMISION ORDEN DE PAGO,,605.13,,Retiro,
897,BBVA,11/12/2024,E20 IVA COMISION ORDEN PAGO,,96.82,,Retiro,
898,BBVA,11/12/2024,N06 PAGO CUENTA DE TERCERO,,900000,,Retiro,
899,BBVA,11/12/2024,N06 PAGO CUENTA DE TERCERO,,30148.4,,Deposito,
900,BBVA,11/12/2024,T20 SPEI RECIBIDOSCOTIABANK,,14152,,Deposito,
901,BBVA,11/12/2024,T20 SPEI RECIBIDOSCOTIABANK,,14152,,Deposito,
902,BBVA,11/12/2024,T20 SPEI RECIBIDOSCOTIABANK,,23200,,Deposito,
903,BBVA,11/12/2024,N06 PAGO CUENTA DE TERCERO,,1488,,Deposito,
904,BBVA,11/12/2024,BT2 TRANSFER BBVA 01002120 L,,20532,,Deposito,
905,BBVA,11/12/2024,E17 ORDEN DE PAGO EXTRANJERO,,31565.7,,Deposito,
906,BBVA,11/12/2024,E18 COMISION ORDEN DE PAGO,,605.13,,Retiro,
907,BBVA,11/12/2024,E20 IVA COMISION ORDEN PAGO,,96.82,,Retiro,
908,BBVA,11/12/2024,T17 SPEI ENVIADO BANORTE,,58123.4,,Retiro,
909,BBVA,11/12/2024,N03 TRASPASO CUENTAS PROPIAS,,1972,,Retiro,
910,BBVA,11/12/2024,N03 TRASPASO CUENTAS PROPIAS,,153128,,Retiro,
911,BBVA,12/12/2024,N06 PAGO CUENTA DE TERCERO,,2320,,Deposito,
912,BBVA,12/12/2024,T20 SPEI RECIBIDOBANORTE,,40600,,Deposito,
913,BBVA,12/12/2024,N06 PAGO CUENTA DE TERCERO,,11205.6,,Deposito,
914,BBVA,13/12/2024,W02 DEPOSITO DE TERCERO,,35496,,Deposito,
915,BBVA,13/12/2024,W02 DEPOSITO DE TERCERO,,5800,,Deposito,
916,BBVA,13/12/2024,T20 SPEI RECIBIDOHSBC,,9894.8,,Deposito,
917,BBVA,13/12/2024,N06 PAGO CUENTA DE TERCERO,,8236,,Deposito,
918,BBVA,13/12/2024,N06 PAGO CUENTA DE TERCERO,,5000,,Retiro,
919,BBVA,13/12/2024,N06 PAGO CUENTA DE TERCERO,,3500,,Retiro,
920,BBVA,13/12/2024,N06 PAGO CUENTA DE TERCERO,,30000,,Retiro,
921,BBVA,13/12/2024,W02 DEPOSITO DE TERCERO,,6699,,Deposito,
922,BBVA,13/12/2024,T20 SPEI RECIBIDOBANAMEX,,6960,,Deposito,
923,BBVA,15/12/2024,T20 SPEI RECIBIDOBANORTE,,20880,,Deposito,
924,BBVA,16/12/2024,T20 SPEI RECIBIDOSANTANDER,,39971.7,,Deposito,
925,BBVA,16/12/2024,W02 DEPOSITO DE TERCERO,,19406.8,,Deposito,
926,BBVA,16/12/2024,T17 SPEI ENVIADO BANREGIO,,2320,,Retiro,
927,BBVA,16/12/2024,N06 PAGO CUENTA DE TERCERO,,7888,,Deposito,
928,BBVA,16/12/2024,T17 SPEI ENVIADO BANORTE,,12180,,Retiro,
929,BBVA,16/12/2024,N06 PAGO CUENTA DE TERCERO,,15612.5,,Retiro,
930,BBVA,16/12/2024,N06 PAGO CUENTA DE TERCERO,,4495,,Deposito,
931,BBVA,16/12/2024,N06 PAGO CUENTA DE TERCERO,,4495,,Deposito,
932,BBVA,16/12/2024,T17 SPEI ENVIADO SANTANDER,,8007.97,,Retiro,
933,BBVA,16/12/2024,T17 SPEI ENVIADO BANREGIO,,4766.66,,Retiro,
934,BBVA,16/12/2024,TJ3 SITB2AT5,,11368,,Deposito,
935,BBVA,16/12/2024,N06 PAGO CUENTA DE TERCERO,,4495,,Deposito,
936,BBVA,16/12/2024,N06 PAGO CUENTA DE TERCERO,,4495,,Deposito,
937,BBVA,17/12/2024,T20 SPEI RECIBIDOBANREGIO,,4176,,Deposito,
938,BBVA,17/12/2024,T20 SPEI RECIBIDOSANTANDER,,45240,,Deposito,
939,BBVA,17/12/2024,T20 SPEI RECIBIDOBANREGIO,,3712,,Deposito,
940,BBVA,17/12/2024,T17 SPEI ENVIADO BAJIO,,84230,,Retiro,
941,BBVA,17/12/2024,T20 SPEI RECIBIDOSANTANDER,,21924,,Deposito,
942,BBVA,17/12/2024,T17 SPEI ENVIADO BANORTE,,42328.4,,Retiro,
943,BBVA,17/12/2024,T17 SPEI ENVIADO SANTANDER,,8007.97,,Retiro,
944,BBVA,18/12/2024,T20 SPEI RECIBIDOCBM BANCO,,68356,,Deposito,
945,BBVA,18/12/2024,T20 SPEI RECIBIDOCBM BANCO,,6292.37,,Deposito,
946,BBVA,18/12/2024,T20 SPEI RECIBIDOCBM BANCO,,8975.33,,Deposito,
947,BBVA,18/12/2024,N03 TRASPASO CUENTAS PROPIAS,,40600,,Retiro,
948,BBVA,18/12/2024,N06 PAGO CUENTA DE TERCERO,,600000,,Retiro,
949,BBVA,18/12/2024,N06 PAGO CUENTA DE TERCERO,,8282.4,,Deposito,
950,BBVA,18/12/2024,T20 SPEI RECIBIDOBANAMEX,,2630.88,,Deposito,
951,BBVA,18/12/2024,N06 PAGO CUENTA DE TERCERO,,19140,,Deposito,
952,BBVA,18/12/2024,T20 SPEI RECIBIDOBANORTE,,2630.88,,Deposito,
953,BBVA,18/12/2024,T20 SPEI RECIBIDOBANORTE,,2630.88,,Deposito,
954,BBVA,18/12/2024,T17 SPEI ENVIADO BANORTE,,2320,,Retiro,
955,BBVA,18/12/2024,N06 PAGO CUENTA DE TERCERO,,5394,,Retiro,
956,BBVA,19/12/2024,T20 SPEI RECIBIDOCBM BANCO,,111360,,Deposito,
957,BBVA,19/12/2024,E01 ORDEN DE PAGO EXTRANJERO,,6746.68,,Retiro,
958,BBVA,19/12/2024,T20 SPEI RECIBIDOSANTANDER,,52200,,Deposito,
959,BBVA,19/12/2024,T20 SPEI RECIBIDOBAJIO,,4060,,Deposito,
960,BBVA,19/12/2024,N06 PAGO CUENTA DE TERCERO,,10788,,Deposito,
961,BBVA,19/12/2024,N06 PAGO CUENTA DE TERCERO,,21576,,Deposito,
962,BBVA,19/12/2024,N06 PAGO CUENTA DE TERCERO,,11232.5,,Retiro,
963,BBVA,19/12/2024,N06 PAGO CUENTA DE TERCERO,,10120.3,,Retiro,
964,BBVA,19/12/2024,N06 PAGO CUENTA DE TERCERO,,4500,,Retiro,
965,BBVA,19/12/2024,W02 DEPOSITO DE TERCERO,,6766.66,,Deposito,
966,BBVA,19/12/2024,N06 PAGO CUENTA DE TERCERO,,2718,,Retiro,
967,BBVA,19/12/2024,N03 TRASPASO CUENTAS PROPIAS,,28002,,Retiro,
968,BBVA,20/12/2024,TJ3 SITB2MCA6693,,41404,,Deposito,
969,BBVA,20/12/2024,W02 DEPOSITO DE TERCERO,,130408,,Deposito,
970,BBVA,20/12/2024,W02 DEPOSITO DE TERCERO,,65204.4,,Deposito,
971,BBVA,20/12/2024,N06 PAGO CUENTA DE TERCERO,,348000,,Deposito,
972,BBVA,20/12/2024,N06 PAGO CUENTA DE TERCERO,,4286,,Deposito,
973,BBVA,20/12/2024,W02 DEPOSITO DE TERCERO,,20044.8,,Deposito,
974,BBVA,20/12/2024,T17 SPEI ENVIADO HSBC,,80774.3,,Retiro,
975,BBVA,20/12/2024,N06 PAGO CUENTA DE TERCERO,,11000,,Retiro,
976,BBVA,20/12/2024,W02 DEPOSITO DE TERCERO,,20044.8,,Deposito,
977,BBVA,20/12/2024,N06 PAGO CUENTA DE TERCERO,,7888,,Deposito,
978,BBVA,20/12/2024,N06 PAGO CUENTA DE TERCERO,,35960,,Deposito,
979,BBVA,20/12/2024,T20 SPEI RECIBIDOBANAMEX,,5800,,Deposito,
980,BBVA,20/12/2024,T20 SPEI RECIBIDOBANAMEX,,52200,,Deposito,
981,BBVA,20/12/2024,N06 PAGO CUENTA DE TERCERO,,27492,,Deposito,
982,BBVA,20/12/2024,N06 PAGO CUENTA DE TERCERO,,1475,,Deposito,
983,BBVA,20/12/2024,W02 DEPOSITO DE TERCERO,,16574.5,,Deposito,
984,BBVA,20/12/2024,T20 SPEI RECIBIDOSANTANDER,,14856,,Deposito,
985,BBVA,20/12/2024,T20 SPEI RECIBIDOSANTANDER,,14856,,Deposito,
986,BBVA,20/12/2024,T20 SPEI RECIBIDOBANORTE,,14856,,Deposito,
987,BBVA,23/12/2024,T09 TEF RECIBIDO HSBC,,85008.5,,Deposito,
988,BBVA,23/12/2024,N06 PAGO CUENTA DE TERCERO,,10567.6,,Deposito,
989,BBVA,23/12/2024,T20 SPEI RECIBIDOSANTANDER,,12780.1,,Deposito,
990,BBVA,23/12/2024,T20 SPEI RECIBIDOSANTANDER,,4054.59,,Deposito,
991,BBVA,23/12/2024,T20 SPEI RECIBIDOSANTANDER,,11677.2,,Deposito,
992,BBVA,23/12/2024,N06 PAGO CUENTA DE TERCERO,,19372,,Deposito,
993,BBVA,23/12/2024,N06 PAGO CUENTA DE TERCERO,,900000,,Retiro,
994,BBVA,23/12/2024,N06 PAGO CUENTA DE TERCERO,,8711.6,,Deposito,
995,BBVA,23/12/2024,N06 PAGO CUENTA DE TERCERO,,33317.1,,Retiro,
996,BBVA,23/12/2024,T20 SPEI RECIBIDOVE POR MAS,,11778.5,,Deposito,
997,BBVA,23/12/2024,T20 SPEI RECIBIDOVE POR MAS,,46980,,Deposito,
998,BBVA,23/12/2024,T20 SPEI RECIBIDOVE POR MAS,,1338.45,,Deposito,
999,BBVA,23/12/2024,N06 PAGO CUENTA DE TERCERO,,16158.8,,Deposito,
1000,BBVA,23/12/2024,N06 PAGO CUENTA DE TERCERO,,9378.6,,Deposito,
1001,BBVA,23/12/2024,N06 PAGO CUENTA DE TERCERO,,6148,,Deposito,
1002,BBVA,24/12/2024,W02 DEPOSITO DE TERCERO,,32480,,Deposito,
1003,BBVA,24/12/2024,N03 TRASPASO CUENTAS PROPIAS,,52200,,Retiro,
1004,BBVA,24/12/2024,T20 SPEI RECIBIDOSANTANDER,,2600,,Deposito,
1005,BBVA,26/12/2024,BT2 TRANSFER BBVA 00812609 L,,44240.6,,Deposito,
1006,BBVA,26/12/2024,T20 SPEI RECIBIDOBANORTE,,36818.4,,Deposito,
1007,BBVA,26/12/2024,N06 PAGO CUENTA DE TERCERO,,358,,Deposito,
1008,BBVA,26/12/2024,W02 DEPOSITO DE TERCERO,,7313.8,,Deposito,
1009,BBVA,26/12/2024,W02 DEPOSITO DE TERCERO,,14244.8,,Deposito,
1010,BBVA,26/12/2024,W02 DEPOSITO DE TERCERO,,28675.2,,Deposito,
1011,BBVA,26/12/2024,T20 SPEI RECIBIDOBANORTE,,57420,,Deposito,
1012,BBVA,26/12/2024,T20 SPEI RECIBIDOBANAMEX,,61347.5,,Deposito,
1013,BBVA,26/12/2024,T20 SPEI RECIBIDOHSBC,,11600,,Deposito,
1014,BBVA,26/12/2024,W02 DEPOSITO DE TERCERO,,13180,,Deposito,
1015,BBVA,27/12/2024,N06 PAGO CUENTA DE TERCERO,,400000,,Retiro,
1016,BBVA,27/12/2024,N06 PAGO CUENTA DE TERCERO,,25520,,Deposito,
1017,BBVA,27/12/2024,T20 SPEI RECIBIDOBANAMEX,,3045,,Deposito,
1018,BBVA,27/12/2024,T20 SPEI RECIBIDOBANAMEX,,2958,,Deposito,
1019,BBVA,27/12/2024,T20 SPEI RECIBIDOBANAMEX,,44198.8,,Deposito,
1020,BBVA,27/12/2024,T20 SPEI RECIBIDOSANTANDER,,40658,,Deposito,
1021,BBVA,27/12/2024,N06 PAGO CUENTA DE TERCERO,,11564.8,,Deposito,
1022,BBVA,27/12/2024,N06 PAGO CUENTA DE TERCERO,,8584,,Deposito,
1023,BBVA,27/12/2024,W02 DEPOSITO DE TERCERO,,19406.8,,Deposito,
1024,BBVA,27/12/2024,T20 SPEI RECIBIDOBANAMEX,,9744,,Deposito,
1025,BBVA,27/12/2024,T20 SPEI RECIBIDOBANORTE,,8236,,Deposito,
1026,BBVA,27/12/2024,W02 DEPOSITO DE TERCERO,,14244.8,,Deposito,
1027,BBVA,27/12/2024,T20 SPEI RECIBIDOBAJIO,,12492.3,,Deposito,
1028,BBVA,27/12/2024,W02 DEPOSITO DE TERCERO,,62257.2,,Deposito,
1029,BBVA,28/12/2024,N06 PAGO CUENTA DE TERCERO,,12760,,Deposito,
1030,BBVA,30/12/2024,N06 PAGO CUENTA DE TERCERO,,13896.8,,Deposito,
1031,BBVA,30/12/2024,N06 PAGO CUENTA DE TERCERO,,10718.4,,Deposito,
1032,BBVA,30/12/2024,N06 PAGO CUENTA DE TERCERO,,6148,,Deposito,
1033,BBVA,30/12/2024,N06 PAGO CUENTA DE TERCERO,,1507.94,,Deposito,
1034,BBVA,30/12/2024,T20 SPEI RECIBIDOBANORTE,,19140,,Deposito,
1035,BBVA,30/12/2024,T20 SPEI RECIBIDOINTERCAM BAN,,17168,,Deposito,
1036,BBVA,30/12/2024,T20 SPEI RECIBIDOSANTANDER,,176795,,Deposito,
1037,BBVA,30/12/2024,W02 DEPOSITO DE TERCERO,,4060,,Deposito,
1038,BBVA,31/12/2024,Y45 COMPENSACION POR RETRASO,,0.16,,Deposito,
1039,BBVA,31/12/2024,T20 SPEI RECIBIDOBANORTE,,270280,,Deposito,
1040,BBVA,31/12/2024,T20 SPEI RECIBIDOBANORTE,,13804,,Deposito,
1041,BBVA,31/12/2024,BT2 TRANSFER BBVA 00848964 L,,23200,,Deposito,
1042,BBVA,05/12/2024,S39 SERV BANCA INTERNET,,450,,Retiro,x
1043,BBVA,05/12/2024,S40 IVA COM SERV BCA INTERNET,,72,,Retiro,
1044,BBVA,06/12/2024,W02 DEPOSITO DE TERCERO,,3480,,Deposito,
1045,BBVA,10/12/2024,N06 PAGO CUENTA DE TERCERO,,4000,,Retiro,
1046,BBVA,18/12/2024,P14 SAT,,459,,Retiro,
1047,BBVA,18/12/2024,P14 SAT,,430,,Retiro,
1048,BBVA,18/12/2024,P14 SAT,,238,,Retiro,
1049,BBVA,18/12/2024,C02 DEPOSITO EN EFECTIVO,,3342.67,,Deposito,
1050,BBVA,20/12/2024,C02 DEPOSITO EN EFECTIVO,,3000,,Deposito,
1051,BBVA,20/12/2024,C02 DEPOSITO EN EFECTIVO,,500,,Deposito,
1052,BBVA,20/12/2024,N06 PAGO CUENTA DE TERCERO,,5000,,Deposito,
1053,BBVA,27/12/2024,T20 SPEI RECIBIDOSANTANDER,,2250,,Deposito,
1054,BBVA,30/12/2024,P14 FUNDACION COMUNITARI,,1950,,Retiro,
1055,BBVA,31/12/2024,N06 PAGO CUENTA DE TERCERO,,9750,,Deposito,
1056,BBVA,02/12/2024,P14 SECRETARIA DE FINANZ,,869,,Retiro,
1057,BBVA,05/12/2024,S39 SERV BANCA INTERNET,,250,,Retiro,
1058,BBVA,05/12/2024,S40 IVA COM SERV BCA INTERNET,,40,,Retiro,
1059,BBVA,02/12/2024,P14 SAT,,14900,,Retiro,
1060,BBVA,02/12/2024,H09 COBRO AUTOMATICO RECIBO,,51818.7,,Retiro,
1061,BBVA,04/12/2024,BT2 TRANSFER BBVA 00841021 L,,21739.1,,Deposito,
1062,BBVA,05/12/2024,S39 SERV BANCA INTERNET,,450,,Retiro,
1063,BBVA,05/12/2024,S39 SERV BANCA INTERNET,,40,,Retiro,
1064,BBVA,05/12/2024,S40 IVA COM SERV BCA INTERNET,,78.4,,Retiro,
1065,BBVA,10/12/2024,T20 SPEI RECIBIDOSCOTIABANK,,53321.4,,Deposito,
1066,BBVA,10/12/2024,BT2 TRANSFER BBVA 00841021 L,,33132.8,,Deposito,
1067,BBVA,10/12/2024,T20 SPEI RECIBIDOSCOTIABANK,,57790.7,,Deposito,
1068,BBVA,10/12/2024,T20 SPEI RECIBIDOSCOTIABANK,,12415.2,,Deposito,
1069,BBVA,12/12/2024,T17 SPEI ENVIADO BANAMEX,,1729.56,,Retiro,
1070,BBVA,13/12/2024,R01 PAGO DE NOMINA,,6517.38,,Retiro,
1071,BBVA,13/12/2024,R09 PAGO DE AGUINALDO,,6655.51,,Retiro,
1072,BBVA,13/12/2024,R01 PAGO DE NOMINA,,30806.5,,Retiro,
1073,BBVA,13/12/2024,R09 PAGO DE AGUINALDO,,32203.5,,Retiro,
1074,BBVA,13/12/2024,T20 SPEI RECIBIDOSCOTIABANK,,15438.6,,Deposito,
1075,BBVA,13/12/2024,T17 SPEI ENVIADO SANTANDER,,6516.5,,Retiro,
1076,BBVA,13/12/2024,T17 SPEI ENVIADO SANTANDER,,6655.51,,Retiro,
1077,BBVA,13/12/2024,T17 SPEI ENVIADO SCOTIABANK,,4851.55,,Retiro,
1078,BBVA,13/12/2024,T17 SPEI ENVIADO SCOTIABANK,,6710.06,,Retiro,
1079,BBVA,17/12/2024,X01 IMSS/INF/AFORE VIA ELECT.,,8085.88,,Retiro,
1080,BBVA,17/12/2024,X01 IMSS/INF/AFORE VIA ELECT.,,15676.6,,Retiro,
1081,BBVA,17/12/2024,N06 PAGO CUENTA DE TERCERO,,15438.6,,Deposito,
1082,BBVA,18/12/2024,P14 SAT,,14187,,Retiro,
1083,BBVA,19/12/2024,N06 PAGO CUENTA DE TERCERO,,11301.4,,Retiro,
1084,BBVA,19/12/2024,N06 PAGO CUENTA DE TERCERO,,11301.4,,Retiro,
1085,BBVA,23/12/2024,T20 SPEI RECIBIDOSANTANDER,,8085.88,,Deposito,
1086,BBVA,23/12/2024,T17 SPEI ENVIADO SANTANDER,,4077,,Retiro,
1087,BBVA,26/12/2024,T20 SPEI RECIBIDOSCOTIABANK,,53321.4,,Deposito,
1088,BBVA,27/12/2024,BT2 TRANSFER BBVA 00841021 L,,54347.9,,Deposito,
1089,BBVA,27/12/2024,R01 PAGO DE NOMINA,,6517.36,,Retiro,
1090,BBVA,27/12/2024,T17 SPEI ENVIADO SANTANDER,,6516.48,,Retiro,
1091,BBVA,30/12/2024,R01 PAGO DE NOMINA,,31014.2,,Retiro,
1092,BBVA,30/12/2024,T17 SPEI ENVIADO SCOTIABANK,,5484.04,,Retiro,
1093,BBVA,30/12/2024,T17 SPEI ENVIADO BANORTE,,8700,,Retiro,
1094,BBVA,30/12/2024,BT2 TRANSFER BBVA 00841021 L,,10869.6,,Deposito,
1095,BBVA,31/12/2024,BT2 TRANSFER BBVA 00841021 L,,108696,,Deposito,
1096,BBVA,02/12/2024,T17 SPEI ENVIADO HSBC,,1500,,Retiro,
1097,BBVA,02/12/2024,N06 PAGO CUENTA DE TERCERO,,10000,,Retiro,
1098,BBVA,04/12/2024,N06 PAGO CUENTA DE TERCERO,,3000,,Retiro,
1099,BBVA,05/12/2024,S39 SERV BANCA INTERNET,,250,,Retiro,
1100,BBVA,05/12/2024,S39 SERV BANCA INTERNET,,40,,Retiro,
1101,BBVA,05/12/2024,S40 IVA COM SERV BCA INTERNET,,46.4,,Retiro,
1102,BBVA,05/12/2024,N06 PAGO CUENTA DE TERCERO,,2500,,Retiro,
1103,BBVA,05/12/2024,N06 PAGO CUENTA DE TERCERO,,500,,Retiro,
1104,BBVA,09/12/2024,T17 SPEI ENVIADO HSBC,,2000,,Retiro,
1105,BBVA,10/12/2024,N06 PAGO CUENTA DE TERCERO,,7429,,Deposito,
1106,BBVA,10/12/2024,N06 PAGO CUENTA DE TERCERO,,1575,,Retiro,
1107,BBVA,12/12/2024,T17 SPEI ENVIADO INBURSA,,1363,,Retiro,
1108,BBVA,13/12/2024,R01 PAGO DE NOMINA,,3011.3,,Retiro,
1109,BBVA,13/12/2024,N06 PAGO CUENTA DE TERCERO,,1750,,Retiro,
1110,BBVA,13/12/2024,T20 SPEI RECIBIDOINBURSA,,170000,,Deposito,
1111,BBVA,14/12/2024,R01 PAGO DE NOMINA,,64251.6,,Retiro,
1112,BBVA,14/12/2024,R01 PAGO DE NOMINA,,89307,,Retiro,
1113,BBVA,17/12/2024,T17 SPEI ENVIADO HSBC,,2000,,Retiro,
1114,BBVA,17/12/2024,T17 SPEI ENVIADO BAJIO,,21180,,Retiro,
1115,BBVA,17/12/2024,N06 PAGO CUENTA DE TERCERO,,3266.1,,Retiro,
1116,BBVA,17/12/2024,N06 PAGO CUENTA DE TERCERO,,266.1,,Retiro,
1117,BBVA,19/12/2024,N06 PAGO CUENTA DE TERCERO,,2000,,Retiro,
1118,BBVA,19/12/2024,N06 PAGO CUENTA DE TERCERO,,963,,Retiro,
1119,BBVA,19/12/2024,N06 PAGO CUENTA DE TERCERO,,2882.24,,Retiro,
1120,BBVA,20/12/2024,T20 SPEI RECIBIDOINBURSA,,50000,,Deposito,
1121,BBVA,23/12/2024,T17 SPEI ENVIADO HSBC,,2000,,Retiro,
1122,BBVA,23/12/2024,N06 PAGO CUENTA DE TERCERO,,20000,,Retiro,
1123,BBVA,23/12/2024,N06 PAGO CUENTA DE TERCERO,,3400,,Retiro,
1124,BBVA,26/12/2024,T17 SPEI ENVIADO AZTECA,,3000,,Retiro,
1125,BBVA,26/12/2024,N06 PAGO CUENTA DE TERCERO,,1850,,Retiro,
1126,BBVA,26/12/2024,T17 SPEI ENVIADO BANAMEX,,300,,Retiro,
1127,BBVA,26/12/2024,N06 PAGO CUENTA DE TERCERO,,1688,,Retiro,
1128,BBVA,27/12/2024,N06 PAGO CUENTA DE TERCERO,,216.3,,Retiro,
1129,BBVA,27/12/2024,N06 PAGO CUENTA DE TERCERO,,2846.95,,Retiro,
1130,BBVA,27/12/2024,T20 SPEI RECIBIDOINBURSA,,50000,,Deposito,
1131,BBVA,28/12/2024,R01 PAGO DE NOMINA,,60877.8,,Retiro,
1132,BBVA,30/12/2024,N06 PAGO CUENTA DE TERCERO,,2000,,Retiro,
1133,BBVA,31/12/2024,Y45 COMPENSACION POR RETRASO,,0.03,,Deposito,
1134,BBVA,01/12/2024,C02 DEPOSITO EN EFECTIVO,,577.86,,Deposito,
1135,BBVA,02/12/2024,P14 TELCEL,,1198,,Retiro,
1136,BBVA,02/12/2024,P14 TELCEL,,1298.08,,Retiro,
1137,BBVA,02/12/2024,P14 TELCEL,,848.99,,Retiro,
1138,BBVA,02/12/2024,P14 TELCEL,,648.99,,Retiro,
1139,BBVA,02/12/2024,P31 VOLKSWAGEN LEASING S05189,,19179.5,,Retiro,
1140,BBVA,05/12/2024,S39 SERV BANCA INTERNET,,250,,Retiro,
1141,BBVA,05/12/2024,S39 SERV BANCA INTERNET,,118,,Retiro,
1142,BBVA,05/12/2024,S40 IVA COM SERV BCA INTERNET,,58.88,,Retiro,
1143,BBVA,05/12/2024,T17 SPEI ENVIADO HSBC,,8500,,Retiro,
1144,BBVA,10/12/2024,N06 PAGO CUENTA DE TERCERO,,1856,,Deposito,
1145,BBVA,10/12/2024,N06 PAGO CUENTA DE TERCERO,,1856,,Deposito,
1146,BBVA,10/12/2024,N06 PAGO CUENTA DE TERCERO,,800,,Retiro,
1147,BBVA,11/12/2024,T17 SPEI ENVIADO MULTIVA BANC,,103240,,Retiro,
1148,BBVA,11/12/2024,T17 SPEI ENVIADO INBURSA,,63220,,Retiro,
1149,BBVA,12/12/2024,N06 PAGO CUENTA DE TERCERO,,4930,,Retiro,
1150,BBVA,12/12/2024,N06 PAGO CUENTA DE TERCERO,,4000,,Retiro,
1151,BBVA,12/12/2024,N06 PAGO CUENTA DE TERCERO,,1500,,Deposito,
1152,BBVA,13/12/2024,T20 SPEI RECIBIDOSCOTIABANK,,3956.71,,Deposito,
1153,BBVA,13/12/2024,T20 SPEI RECIBIDOSCOTIABANK,,3956.71,,Deposito,
1154,BBVA,13/12/2024,P14 EFECTIVALE S DE RL D,,5406,,Retiro,
1155,BBVA,13/12/2024,P14 EFECTIVALE S DE RL D,,139,,Retiro,
1156,BBVA,13/12/2024,T20 SPEI RECIBIDOMULTIVA BANC,,0.01,,Deposito,
1157,BBVA,13/12/2024,T20 SPEI RECIBIDOBANORTE,,9280,,Deposito,
1158,BBVA,14/12/2024,R01 PAGO DE NOMINA,,16776.1,,Retiro,
1159,BBVA,16/12/2024,N06 PAGO CUENTA DE TERCERO,,11310,,Deposito,
1160,BBVA,17/12/2024,N06 PAGO CUENTA DE TERCERO,,800,,Retiro,
1161,BBVA,17/12/2024,N06 PAGO CUENTA DE TERCERO,,400,,Retiro,
1162,BBVA,17/12/2024,X01 IMSS/INF/AFORE VIA ELECT.,,2315.28,,Retiro,
1163,BBVA,17/12/2024,N06 PAGO CUENTA DE TERCERO,,470.48,,Retiro,
1164,BBVA,17/12/2024,N06 PAGO CUENTA DE TERCERO,,470.48,,Retiro,
1165,BBVA,17/12/2024,N06 PAGO CUENTA DE TERCERO,,470.48,,Retiro,
1166,BBVA,17/12/2024,N06 PAGO CUENTA DE TERCERO,,470.48,,Retiro,
1167,BBVA,18/12/2024,N06 PAGO CUENTA DE TERCERO,,21446,,Deposito,
1168,BBVA,18/12/2024,P14 GOBIERNO DEL ESTADO,,1563,,Retiro,
1169,BBVA,19/12/2024,P14 EFECTIVALE S DE RL D,,6006,,Retiro,
1170,BBVA,20/12/2024,N06 PAGO CUENTA DE TERCERO,,20000,,Retiro,
1171,BBVA,20/12/2024,T20 SPEI RECIBIDOBANORTE,,9280,,Deposito,
1172,BBVA,20/12/2024,P14 AMERICAN EXPRESS,,34338.6,,Retiro,
1173,BBVA,20/12/2024,T20 SPEI RECIBIDOBANORTE,,9280,,Deposito,
1174,BBVA,23/12/2024,P14 CFE,,4081,,Retiro,
1175,BBVA,23/12/2024,P14 SAT,,37718,,Retiro,
1176,BBVA,23/12/2024,N06 PAGO CUENTA DE TERCERO,,20000,,Deposito,
1177,BBVA,24/12/2024,P31 GPO NACIONAL PROVINC00390,,15527.2,,Retiro,
1178,BBVA,26/12/2024,N06 PAGO CUENTA DE TERCERO,,34020.1,,Retiro,
1179,BBVA,26/12/2024,N06 PAGO CUENTA DE TERCERO,,299280,,Deposito,
1180,BBVA,26/12/2024,T17 SPEI ENVIADO INBURSA,,103240,,Retiro,
1181,BBVA,26/12/2024,T17 SPEI ENVIADO INBURSA,,126440,,Retiro,
1182,BBVA,26/12/2024,P14 AMERICAN EXPRESS,,5561,,Retiro,
1183,BBVA,26/12/2024,P14 AMERICAN EXPRESS,,8988,,Retiro,
1184,BBVA,26/12/2024,P14 AMERICAN EXPRESS,,11546,,Retiro,
1185,BBVA,26/12/2024,N05 PAGO TARJETA DE TERCEROS,,825,,Retiro,
1186,BBVA,26/12/2024,P14 EFECTIVALE S DE RL D,,6006,,Retiro,
1187,BBVA,26/12/2024,T17 SPEI ENVIADO SANTANDER,,20000,,Retiro,
1188,BBVA,27/12/2024,T20 SPEI RECIBIDOJP MORGAN,,5771.23,,Deposito,
1189,BBVA,27/12/2024,N06 PAGO CUENTA DE TERCERO,,150000,,Deposito,
1190,BBVA,27/12/2024,N06 PAGO CUENTA DE TERCERO,,150000,,Retiro,
1191,BBVA,27/12/2024,N06 PAGO CUENTA DE TERCERO,,149640,,Deposito,
1192,BBVA,27/12/2024,N06 PAGO CUENTA DE TERCERO,,78880,,Deposito,
1193,BBVA,28/12/2024,R01 PAGO DE NOMINA,,16776.1,,Retiro,
1194,BBVA,30/12/2024,N06 PAGO CUENTA DE TERCERO,,15000,,Retiro,
1195,BBVA,30/12/2024,N06 PAGO CUENTA DE TERCERO,,200100,,Deposito,
1196,BBVA,30/12/2024,N06 PAGO CUENTA DE TERCERO,,20000,,Retiro,
1197,BBVA,30/12/2024,T17 SPEI ENVIADO BANORTE,,348000,,Retiro,
1198,BBVA,30/12/2024,N06 PAGO CUENTA DE TERCERO,,200100,,Deposito,
1199,BBVA,30/12/2024,T17 SPEI ENVIADO SANTANDER,,7000,,Retiro,
1200,BBVA,31/12/2024,N06 PAGO CUENTA DE TERCERO,,11310,,Deposito,
